'|
'βαλα|v ˈa l a
'γω|ɣ ˈo
'θελε|θ ˈe l e
'λεγες|l ˈe j e s
'ξερες|k s ˈe r e s
'ρχόσουν|r x ˈo s u n
'σαι|s ˈe
'σπαζαν|s p ˈa z a n
'στριψε|s t r ˈi p s e
'ταν|t ˈa n
'χάσε|x ˈa s e
'χουν|x ˈu n
'χω|x ˈo
aπό|(en) ˈeɪ (el) p ˈo
hangover|(en) h ˈa ŋ ɡ əʊ v ə (el)
ib'|(en) ˈɪ b (el)
ie'|(en) ˈaɪ iː  (el)
mπορούν|(en) ˈɛ m (el) p o r ˈu n
«|
«άνθρωπο»|ˈa n θ r o p ˌo
«έλα|ˈe l a
«αν|ˈa n
«αντάρα»|a d ˈa r a
«αντάρας»|a d ˈa r a s
«γιατί|j a t ˈi
«εξοχώτατε|ˌe k s o x ˈo t a t ˌe
«κάμαρα»|k ˈa m a r ˌa
«καλά|k a l ˈa
«κύρου|c ˈi r u
«λοιπόν|l i p ˈo n
«μην|m ˈi n
«μυστική|m ˌi s t i c ˈi
«ο|ˈo m i k r ˌo n
«πολυτρανότατε|p ˌo l i t r a n ˈo t a t ˌe
«ρίξου|r ˈi k s u
«σχολείο|s x o l ˈi  o
«σχολείου|s x o l ˈi  u
«το|t ˈo
«τρομάρα»|t r o m ˈa r a
«τρομάρας»|t r o m ˈa r a s
«όχι|ˈo ç i
´ναι|n ˈe
»|
άγιος|ˈa j o s
άγνωστος|ˈa ɣ n o s t ˌo s
άγρια|ˈa ɣ r i  ˌa
άγριες|ˈa ɣ r i  ˌe s
άδεια|ˈa ð ç a
άδειασε|ˈa ð ç a s ˌe
άδειες|ˈa ð ç e s
άδειο|ˈa ð ç o
άδικα|ˈa ð i k ˌa
άεργες|ˈa e r j ˌe s
άκαρδες|ˈa k a r ð ˌe s
άκου|ˈa k u
άκουε|ˈa k u ˌe
άκουσαν|ˈa k u s ˌa n
άκουσε|ˈa k u s ˌe
άκουσες|ˈa k u s ˌe s
άκρες|ˈa k r e s
άκρη|ˈa k r i
άλέιψε|ˈa l ˈe i p s ˌe
άλεσαν|ˈa l e s ˌa n
άλλα|ˈa l a
άλλαξαν|ˈa l a k s ˌa n
άλλαξε|ˈa l a k s ˌe
άλλες|ˈa l e s
άλλη|ˈa l i
άλλης|ˈa l i s
άλλο|ˈa l o
άλλοι|ˈa l i
άλλον|ˈa l o n
άλλος|ˈa l o s
άλλοτε|ˈa l o t ˌe
άλλου|ˈa l u
άλλους|ˈa l u s
άλλων|ˈa l o n
άλλωστε|ˈa l o s t ˌe
άλο|ˈa l o
άλογ|ˈa l o ɣ
άλογα|ˈa l o ɣ ˌa
άλογο|ˈa l o ɣ ˌo
άλυτο|ˈa l i t ˌo
άλφα|ˈa l f a
άναβε|ˈa n a v ˌe
άνανδροι|ˈa n a n ð r ˌi
άναψαν|ˈa n a p s ˌa n
άναψε|ˈa n a p s ˌe
άνεμος|ˈa n e m ˌo s
άνεση|ˈa n e s ˌi
άνθιζαν|ˈa n θ i z ˌa n
άνθρωπε|ˈa n θ r o p ˌe
άνθρωπο|ˈa n θ r o p ˌo
άνθρωπο»|ˈa n θ r o p ˌo
άνθρωποι|ˈa n θ r o p ˌi
άνθρωπος|ˈa n θ r o p ˌo s
άνοιγε|ˈa n i j ˌe
άνοιξαν|ˈa n i k s ˌa n
άνοιξε|ˈa n i k s ˌe
άνοστος|ˈa n o s t ˌo s
άντρας|ˈa d r a s
άντρες|ˈa d r e s
άνω|ˈa n o
άξαφνα|ˈa k s a f n ˌa
άξια|ˈa k s i  ˌa
άξιο|ˈa k s i  ˌo
άξιοι|ˈa k s i  ˌi
άξιος|ˈa k s i  ˌo s
άπλυτες|ˈa p l i t ˌe s
άπλωναν|ˈa p l o n ˌa n
άπλωνε|ˈa p l o n ˌe
άπλωσε|ˈa p l o s ˌe
άραξαν|ˈa r a k s ˌa n
άργησαν|ˈa r j i s ˌa n
άρεσαν|ˈa r e s ˌa n
άρματα|ˈa r m a t ˌa
άρμεγαν|ˈa r m e ɣ ˌa n
άρμεγε|ˈa r m e j ˌe
άρπαξα|ˈa r p a k s ˌa
άρπαξαν|ˈa r p a k s ˌa n
άρπαξε|ˈa r p a k s ˌe
άρρωστος|ˈa r o s t ˌo s
άρχι|ˈa r ç i
άρχιζαν|ˈa r ç i z ˌa n
άρχιζε|ˈa r ç i z ˌe
άρχισαν|ˈa r ç i s ˌa n
άρχισε|ˈa r ç i s ˌe
άρχισες|ˈa r ç i s ˌe s
άρχοντα|ˈa r x o d ˌa
άρχοντας|ˈa r x o d ˌa s
άσκοπα|ˈa s k o p ˌa
άσπρα|ˈa s p r a
άσπρη|ˈa s p r i
άσπριζε|ˈa s p r i z ˌe
άσπρισε|ˈa s p r i s ˌe
άσπρο|ˈa s p r o
άσπροι|ˈa s p r i
άστα|ˈa s t a
άστραψαν|ˈa s t r a p s ˌa n
άτακτα|ˈa t a k t ˌa
άφηνε|ˈa f i n ˌe
άφησαν|ˈa f i s ˌa n
άφησε|ˈa f i s ˌe
άφωνος|ˈa f o n ˌo s
άχρηστα|ˈa x r i s t ˌa
άχρηστοι|ˈa x r i s t ˌi
άχυρα|ˈa ç i r ˌa
άχυρο|ˈa ç i r ˌo
άψητα|ˈa p s i t ˌa
έβαλαν|ˈe v a l ˌa n
έβαλε|ˈe v a l ˌe
έβγα|ˈe v ɣ a
έβγαζα|ˈe v ɣ a z ˌa
έβγαζαν|ˈe v ɣ a z ˌa n
έβγαζε|ˈe v ɣ a z ˌe
έβγαιναν|ˈe v j e n ˌa n
έβγαινε|ˈe v j e n ˌe
έβγαλαν|ˈe v ɣ a l ˌa n
έβγαλε|ˈe v ɣ a l ˌe
έβλαψε|ˈe v l a p s ˌe
έβλεπα|ˈe v l e p ˌa
έβλεπε|ˈe v l e p ˌe
έβλεπες|ˈe v l e p ˌe s
έβοσκαν|ˈe v o s k ˌa n
έβραζαν|ˈe v r a z ˌa n
έβρασα|ˈe v r a s ˌa
έβρεχε|ˈe v r e ç ˌe
έβρισε|ˈe v r i s ˌe
έβρισκα|ˈe v r i s k ˌa
έβρισκαν|ˈe v r i s k ˌa n
έβρισκε|ˈe v r i s c ˌe
έβρισκες|ˈe v r i s c ˌe s
έγειρε|ˈe j i r ˌe
έγιναν|ˈe j i n ˌa n
έγινε|ˈe j i n ˌe
έγνεφε|ˈe ɣ n e f ˌe
έγνεψε|ˈe ɣ n e p s ˌe
έγραφε|ˈe ɣ r a f ˌe
έγραψαν|ˈe ɣ r a p s ˌa n
έγραψε|ˈe ɣ r a p s ˌe
έδειξαν|ˈe ð i k s ˌa n
έδειξε|ˈe ð i k s ˌe
έδεναν|ˈe ð e n ˌa n
έδενε|ˈe ð e n ˌe
έδεσαν|ˈe ð e s ˌa n
έδεσε|ˈe ð e s ˌe
έδινε|ˈe ð i n ˌe
έδιωξαν|ˈe ð i  ˌo k s a n
έδιωξε|ˈe ð i  ˌo k s e
έδωσαν|ˈe ð o s ˌa n
έδωσε|ˈe ð o s ˌe
έδωσες|ˈe ð o s ˌe s
έζωσε|ˈe z o s ˌe
έθαψαν|ˈe θ a p s ˌa n
έθνος|ˈe θ n o s
έθνους|ˈe θ n u s
έκαιαν|ˈe c e ˌa n
έκαιε|ˈe c e ˌe
έκαμε|ˈe k a m ˌe
έκανα|ˈe k a n ˌa
έκαναν|ˈe k a n ˌa n
έκανε|ˈe k a n ˌe
έκανες|ˈe k a n ˌe s
έκλαιγε|ˈe k l e j ˌe
έκλαψε|ˈe k l a p s ˌe
έκλεβε|ˈe k l e v ˌe
έκλεισαν|ˈe k l i s ˌa n
έκλεισε|ˈe k l i s ˌe
έκλεψε|ˈe k l e p s ˌe
έκλεψες|ˈe k l e p s ˌe s
έκοβαν|ˈe k o v ˌa n
έκοψε|ˈe k o p s ˌe
έκπληξη|ˈe k p l i k s ˌi
έκρυψε|ˈe k r i p s ˌe
έκσταση|ˈe k s t a s ˌi
έλα|ˈe l a
έλαβε|ˈe l a v ˌe
έλαμπε|ˈe l a b ˌe
έλαμψε|ˈe l a m p s ˌe
έλαχε|ˈe l a ç ˌe
έλεγαν|ˈe l e ɣ ˌa n
έλεγε|ˈe l e j ˌe
έλεγες|ˈe l e j ˌe s
έλεγχο|ˈe l e ŋ x ˌo
έλειπαν|ˈe l i p ˌa n
έλειπε|ˈe l i p ˌe
έλειπες|ˈe l i p ˌe s
έληξε|ˈe l i k s ˌe
έλθει|ˈe l θ i
έλθεις|ˈe l θ i s
έλθομε|ˈe l θ o m ˌe
έλθουν|ˈe l θ u n
έλθω|ˈe l θ o
έμαθα|ˈe m a θ ˌa
έμαθε|ˈe m a θ ˌe
έμαθες|ˈe m a θ ˌe s
έμεινα|ˈe m i n ˌa
έμειναν|ˈe m i n ˌa n
έμεινε|ˈe m i n ˌe
έμεινεν|ˈe m i n ˌe n
έμεινες|ˈe m i n ˌe s
έμεναν|ˈe m e n ˌa n
έμενε|ˈe m e n ˌe
έμοιαζε|ˈe m i  ˌa z e
έμπα|ˈe b a
έμπαιναν|ˈe b e n ˌa n
έμπηξε|ˈe b i k s ˌe
ένα|ˈe n a
έναν|ˈe n a n
ένας|ˈe n a s
ένιωσε|ˈe ɲ o s ˌe
έντομα|ˈe d o m ˌa
έντομο|ˈe d o m ˌo
ένωναν|ˈe n o n ˌa n
έξαφνα|ˈe k s a f n ˌa
έξαψη|ˈe k s a p s ˌi
έξι|ˈe k s i
έξυσε|ˈe k s i s ˌe
έπαθα|ˈe p a θ ˌa
έπαθαν|ˈe p a θ ˌa n
έπαθε|ˈe p a θ ˌe
έπαθες|ˈe p a θ ˌe s
έπαιζαν|ˈe p e z ˌa n
έπαιζε|ˈe p e z ˌe
έπαιρναν|ˈe p e r n ˌa n
έπαιρνε|ˈe p e r n ˌe
έπαυσαν|ˈe p a f s ˌa n
έπαυσε|ˈe p a f s ˌe
έπειτα|ˈe p i t ˌa
έπεσαν|ˈe p e s ˌa n
έπεσε|ˈe p e s ˌe
έπεφταν|ˈe p e f t ˌa n
έπεφτε|ˈe p e f t ˌe
έπιανε|ˈe p ç a n ˌe
έπιασαν|ˈe p ç a s ˌa n
έπιασε|ˈe p ç a s ˌe
έπιναν|ˈe p i n ˌa n
έπινε|ˈe p i n ˌe
έπιπλα|ˈe p i p l ˌa
έπιπλο|ˈe p i p l ˌo
έπλεκαν|ˈe p l e k ˌa n
έπλεκε|ˈe p l e c ˌe
έπλενε|ˈe p l e n ˌe
έραψε|ˈe r a p s ˌe
έρημης|ˈe r i m ˌi s
έρθει|ˈe r θ i
έρθω|ˈe r θ o
έριξα|ˈe r i k s ˌa
έριξαν|ˈe r i k s ˌa n
έριξε|ˈe r i k s ˌe
έριχναν|ˈe r i x n ˌa n
έριχνε|ˈe r i x n ˌe
έρχεσαι|ˈe r ç e s ˌe
έρχεστε|ˈe r ç e s t ˌe
έρχεται|ˈe r ç e t ˌe
έρχομαι|ˈe r x o m ˌe
έρχονται|ˈe r x o d ˌe
έρχονταν|ˈe r x o d ˌa n
έρχουμουν|ˈe r x u m ˌu n
έρχουνταν|ˈe r x u d ˌa n
έσβησε|ˈe s v i s ˌe
έσερναν|ˈe s e r n ˌa n
έσερνε|ˈe s e r n ˌe
έσκαβα|ˈe s k a v ˌa
έσκαβαν|ˈe s k a v ˌa n
έσκασε|ˈe s k a s ˌe
έσκασες|ˈe s k a s ˌe s
έσκυψαν|ˈe s c i p s ˌa n
έσκυψε|ˈe s c i p s ˌe
έσπασε|ˈe s p a s ˌe
έσπερναν|ˈe s p e r n ˌa n
έσπρωξαν|ˈe s p r o k s ˌa n
έσπρωξε|ˈe s p r o k s ˌe
έσταζε|ˈe s t a z ˌe
έστειλα|ˈe s t i l ˌa
έστειλαν|ˈe s t i l ˌa n
έστειλε|ˈe s t i l ˌe
έστειλες|ˈe s t i l ˌe s
έστεκαν|ˈe s t e k ˌa n
έστεκε|ˈe s t e c ˌe
έστελνε|ˈe s t e l n ˌe
έστεψε|ˈe s t e p s ˌe
έστησε|ˈe s t i s ˌe
έστριψε|ˈe s t r i p s ˌe
έστρωναν|ˈe s t r o n ˌa n
έστρωσε|ˈe s t r o s ˌe
έστω|ˈe s t o
έσυραν|ˈe s i r ˌa n
έσυρε|ˈe s i r ˌe
έσφαζαν|ˈe s f a z ˌa n
έσφαξαν|ˈe s f a k s ˌa n
έσφιγγε|ˈe s f i ŋ ɡ ˌe
έσφιξε|ˈe s f i k s ˌe
έσχισε|ˈe s ç i s ˌe
έσωσαν|ˈe s o s ˌa n
έσωσες|ˈe s o s ˌe s
έτοιμα|ˈe t i m ˌa
έτοιμες|ˈe t i m ˌe s
έτοιμο|ˈe t i m ˌo
έτοιμοι|ˈe t i m ˌi
έτοιμος|ˈe t i m ˌo s
έτρεμε|ˈe t r e m ˌe
έτρεξαν|ˈe t r e k s ˌa n
έτρεξε|ˈe t r e k s ˌe
έτρεχαν|ˈe t r e x ˌa n
έτρεχε|ˈe t r e ç ˌe
έτρεψαν|ˈe t r e p s ˌa n
έτρεψε|ˈe t r e p s ˌe
έτριψε|ˈe t r i p s ˌe
έτρωγαν|ˈe t r o ɣ ˌa n
έτρωγε|ˈe t r o j ˌe
έτσι|ˈe ts i
έτσουξε|ˈe ts u k s ˌe
έτυχε|ˈe t i ç ˌe
έφαγα|ˈe f a ɣ ˌa
έφαγαν|ˈe f a ɣ ˌa n
έφαγε|ˈe f a j ˌe
έφαγες|ˈe f a j ˌe s
έφεραν|ˈe f e r ˌa n
έφερε|ˈe f e r ˌe
έφερες|ˈe f e r ˌe s
έφερναν|ˈe f e r n ˌa n
έφερνε|ˈe f e r n ˌe
έφευγαν|ˈe f e v ɣ ˌa n
έφευγε|ˈe f e v j ˌe
έφθανα|ˈe f θ a n ˌa
έφθαναν|ˈe f θ a n ˌa n
έφθανε|ˈe f θ a n ˌe
έφθανες|ˈe f θ a n ˌe s
έφθασαν|ˈe f θ a s ˌa n
έφθασε|ˈe f θ a s ˌe
έφταιγε|ˈe f t e j ˌe
έφτιανα|ˈe f t i  ˌa n a
έφτιανε|ˈe f t i  ˌa n e
έφτιασα|ˈe f t i  ˌa s a
έφτιασε|ˈe f t i  ˌa s e
έφυγα|ˈe f i ɣ ˌa
έφυγαν|ˈe f i ɣ ˌa n
έφυγε|ˈe f i j ˌe
έφυγες|ˈe f i j ˌe s
έχανε|ˈe x a n ˌe
έχασα|ˈe x a s ˌa
έχασαν|ˈe x a s ˌa n
έχασε|ˈe x a s ˌe
έχασκαν|ˈe x a s k ˌa n
έχασκε|ˈe x a s c ˌe
έχει|ˈe ç i
έχεις|ˈe ç i s
έχετε|ˌe ç e t ˈe
έχομε|ˈe x o m ˌe
έχουν|ˈe x u n
έχτιζαν|ˈe x t i z ˌa n
έχτιζε|ˈe x t i z ˌe
έχτισαν|ˈe x t i s ˌa n
έχυσε|ˈe ç i s ˌe
έχωσε|ˈe x o s ˌe
έψησε|ˈe p s i s ˌe
ή|ˌi t a t ˈo n o s
ήθελα|ˈi θ e l ˌa
ήθελαν|ˈi θ e l ˌa n
ήθελε|ˈi θ e l ˌe
ήθελες|ˈi θ e l ˌe s
ήλθα|ˈi l θ a
ήλθαμε|ˈi l θ a m ˌe
ήλθαν|ˈi l θ a n
ήλθε|ˈi l θ e
ήλθες|ˈi l θ e s
ήλιο|ˈi ʎ o
ήλιος|ˈi ʎ o s
ήλιου|ˈi ʎ u
ήξερα|ˈi k s e r ˌa
ήξεραν|ˈi k s e r ˌa n
ήξερε|ˈi k s e r ˌe
ήξερες|ˈi k s e r ˌe s
ήρθα|ˈi r θ a
ήρθαμε|ˈi r θ a m ˌe
ήρθε|ˈi r θ e
ήρχουνταν|ˈi r x u d ˌa n
ήρωα|ˈi r o ˌa
ήρωες|ˈi r o ˌe s
ήσουν|ˈi s u n
ήσυχα|ˈi s i x ˌa
ήσυχο|ˈi s i x ˌo
ήσυχοι|ˈi s i ç ˌi
ήσυχος|ˈi s i x ˌo s
ήσυχους|ˈi s i x ˌu s
ήχος|ˈi x o s
ίδια|ˈi ð j a
ίδιας|ˈi ð i  ˌa s
ίδιο|ˈi ð i  ˌo
ίδιοι|ˈi ð i  ˌi
ίδιος|ˈi ð i  ˌo s
ίσα|ˈi s a
ίσια|ˈi s j a
ίσιασε|ˈi s j a s ˌe
ίσκιο|ˈi s c o
ίσο|ˈi s o
ίσως|ˈi s o s
α|ˈa l f a
α'|ˈa l f a
αέρα|a ˈe r a
αίμα|ˈe m a
αίματος|ˈe m a t ˌo s
αγάλι|a ɣ ˈa l i
αγάπη|a ɣ ˈa p i
αγάπησες|a ɣ ˈa p i s ˌe s
αγέλαστο|a j ˈe l a s t ˌo
αγανάκτηση|ˌa ɣ a n ˈa k t i s ˌi
αγαπημένο|ˌa ɣ a p i m ˈe n o
αγαπούσε|ˌa ɣ a p ˈu s e
αγελάδα|ˌa j e l ˈa ð a
αγελάδες|ˌa j e l ˈa ð e s
αγκάθια|a ŋ ɡ ˈa θ i  ˌa
αγκάλιασε|a ŋ ɡ ˈa ʎ a s ˌe
αγκαλά|ˌa ŋ ɡ a l ˈa
αγκαλιά|ˌa ŋ ɡ a ʎ ˈa
αγκαλιάζοντας|ˌa ŋ ɡ a ʎ ˈa z o d ˌa s
αγκωνές|ˌa ŋ ɡ o n ˈe s
αγοράζει|ˌa ɣ o r ˈa z i
αγοράζουν|ˌa ɣ o r ˈa z u n
αγοράσει|ˌa ɣ o r ˈa s i
αγοράσεις|ˌa ɣ o r ˈa s i s
αγοράσουν|ˌa ɣ o r ˈa s u n
αγορίστικο|ˌa ɣ o r ˈi s t i k ˌo
αγοριού|ˌa ɣ o r i  ˈu
αγουρίδα|ˌa ɣ u r ˈi ð a
αγουροξυπνημένο|ˌa ɣ u r ˌo k s i p n i m ˈe n o
αγρίμια|a ɣ r ˈi m i  ˌa
αγριεμένα|ˌa ɣ r i  e m ˈe n a
αγριεμένες|ˌa ɣ r i  e m ˈe n e s
αγριεμένο|ˌa ɣ r i  e m ˈe n o
αγριεύει|ˌa ɣ r i  ˈe v i
αγριοκάτσικα|ˌa ɣ r i  o k ˈa ts i k ˌa
αγριολούλουδα|ˌa ɣ r i  o l ˈu l u ð ˌa
αγριοράδικα|ˌa ɣ r i  o r ˈa ð i k ˌa
αγριοφραουλιά|ˌa ɣ r i  ˌo f r a u ʎ ˈa
αγριοφραουλιές|ˌa ɣ r i  ˌo f r a u ʎ ˈe s
αγριόπαπια|ˌa ɣ r i  ˈo p a p ç ˌa
αγριόπαπιες|ˌa ɣ r i  ˈo p a p ç ˌe s
αγριόπουλα|ˌa ɣ r i  ˈo p u l ˌa
αγριόπουλο|ˌa ɣ r i  ˈo p u l ˌo
αγριόχορτα|ˌa ɣ r i  ˈo x o r t ˌa
αγροτικά|ˌa ɣ r o t i k ˈa
αγωνία|ˌa ɣ o n ˈi  a
αγόραζα|a ɣ ˈo r a z ˌa
αγόραζαν|a ɣ ˈo r a z ˌa n
αγόραζες|a ɣ ˈo r a z ˌe s
αγόρασα|a ɣ ˈo r a s ˌa
αγόρι|a ɣ ˈo r i
αγόρια|a ɣ ˈo r i  ˌa
αγώνα|a ɣ ˈo n a
αδέλφια|a ð ˈe l f i  ˌa
αδειάσει|a ð ç ˈa s i
αδειανά|ˌa ð ç a n ˈa
αδειανό|ˌa ð ç a n ˈo
αδελφάκια|ˌa ð e l f ˈa c a
αδελφέ|ˌa ð e l f ˈe
αδελφές|ˌa ð e l f ˈe s
αδελφής|ˌa ð e l f ˈi s
αδελφικά|ˌa ð e l f i k ˈa
αδελφοί|ˌa ð e l f ˈi
αδελφού|ˌa ð e l f ˈu
αδελφούλα|ˌa ð e l f ˈu l a
αδελφούς|ˌa ð e l f ˈu s
αδελφό|ˌa ð e l f ˈo
αδελφός|ˌa ð e l f ˈo s
αδιάβατους|ˌa ð i  ˈa v a t ˌu s
αδιάκοπα|ˌa ð i  ˈa k o p ˌa
αδιάφορη|ˌa ð i  ˈa f o r ˌi
αδιάφορος|ˌa ð i  ˈa f o r ˌo s
αδιαφορώντας|ˌa ð i  ˌa f o r ˈo d a s
αδούλευτα|a ð ˈu l e f t ˌa
αδύνατο|a ð ˈi n a t ˌo
αδύνατος|a ð ˈi n a t ˌo s
αειφόρου|ˌa i f ˈo r u
αεράκι|ˌa e r ˈa c i
αετουδάκι|ˌa e t u ð ˈa c i
αηδιασμένο|ˌaɪ ð i  a s m ˈe n o
αθώο|a θ ˈo o
αιδηψού|ˌe ð i p s ˈu
αιματωμένο|ˌe m a t o m ˈe n o
αισθάνθηκε|e s θ ˈa n θ i c ˌe
αισθάνθηκες|e s θ ˈa n θ i c ˌe s
αιώνια|e ˈo ɲ a
αιώνιους|e ˈo ɲ u s
ακίνητες|a c ˈi n i t ˌe s
ακίνητοι|a c ˈi n i t ˌi
ακίνητος|a c ˈi n i t ˌo s
ακαλλιέργητες|ˌa k a ʎ ˈe r j i t ˌe s
ακαλλιέργητο|ˌa k a ʎ ˈe r j i t ˌo
ακαλλιέργητους|ˌa k a ʎ ˈe r j i t ˌu s
ακατάδεκτη|ˌa k a t ˈa ð e k t ˌi
ακατάστατο|ˌa k a t ˈa s t a t ˌo
ακατοίκητη|ˌa k a t ˈi c i t ˌi
ακολουθήσαμε|ˌa k o l u θ ˈi s a m ˌe
ακολουθήσει|ˌa k o l u θ ˈi s i
ακολουθήσετε|ˌa k o l u θ ˈi s e t ˌe
ακολουθήσομε|ˌa k o l u θ ˈi s o m ˌe
ακολουθήσουν|ˌa k o l u θ ˈi s u n
ακολουθήστε|ˌa k o l u θ ˈi s t e
ακολουθείτε|ˌa k o l u θ ˈi t e
ακολουθούν|ˌa k o l u θ ˈu n
ακολουθούσαν|ˌa k o l u θ ˈu s a n
ακολουθούσε|ˌa k o l u θ ˈu s e
ακολουθούσες|ˌa k o l u θ ˈu s e s
ακολουθώντας|ˌa k o l u θ ˈo d a s
ακολούθα|ˌa k o l ˈu θ a
ακολούθησαν|ˌa k o l ˈu θ i s ˌa n
ακολούθησε|ˌa k o l ˈu θ i s ˌe
ακουμπά|ˌa k u b ˈa
ακουμπήσει|ˌa k u b ˈi s i
ακουμπισμένα|ˌa k u b i s m ˈe n a
ακουμπισμένο|ˌa k u b i s m ˈe n o
ακούει|a k ˈu i
ακούμπησε|a k ˈu b i s ˌe
ακούονται|a k ˈu o d ˌe
ακούοντας|a k ˈu o d ˌa s
ακούουνταν|a k ˈu u d ˌa n
ακούραστα|a k ˈu r a s t ˌa
ακούραστη|a k ˈu r a s t ˌi
ακούς|a k ˈu s
ακούσει|a k ˈu s i
ακούσεις|a k ˈu s i s
ακούσομε|a k ˈu s o m ˌe
ακούσουμε|a k ˈu s u m ˌe
ακούσουν|a k ˈu s u n
ακούστηκαν|a k ˈu s t i k ˌa n
ακούσω|a k ˈu s o
ακούτε|a k ˈu t e
ακούω|a k ˈu o
ακράτητος|a k r ˈa t i t ˌo s
ακριβά|ˌa k r i v ˈa
ακριβό|ˌa k r i v ˈo
ακριβώς|ˌa k r i v ˈo s
ακρολιμνιά|ˌa k r o l i m ɲ ˈa
ακροποταμιά|ˌa k r o p ˌo t a m i  ˈa
ακόμα|a k ˈo m a
ακόμη|a k ˈo m i
αλέτρια|a l ˈe t r i  ˌa
αλήθεια|a l ˈi θ ç a
αλήθειες|a l ˈi θ ç e s
αλίμονα|a l ˈi m o n ˌa
αλαλάζοντας|ˌa l a l ˈa z o d ˌa s
αλατίσουν|ˌa l a t ˈi s u n
αλειμματοκέρι|ˌa l i m ˌa t o c ˈe r i
αλεπουδίσιο|ˌa l e p u ð ˈi s j o
αλεύρι|a l ˈe v r i
αληθινό|ˌa l i θ i n ˈo
αλητόπαιδα|ˌa l i t ˈo p e ð ˌa
αλλ'|ˈa l
αλλά|a l ˈa
αλλάζει|a l ˈa z i
αλλάζεται|a l ˈa z e t ˌe
αλλάζοντας|a l ˈa z o d ˌa s
αλλάξει|a l ˈa k s i
αλλαγμένο|ˌa l a ɣ m ˈe n o
αλλιώς|a ʎ ˈo s
αλλιώτικα|a ʎ ˈo t i k ˌa
αλυσίδας|ˌa l i s ˈi ð a s
αλυσίδες|ˌa l i s ˈi ð e s
αλυσοδεμένο|ˌa l i s ˌo ð e m ˈe n o
αλόγου|a l ˈo ɣ u
αμ'|ˈa m
αμάθητη|a m ˈa θ i t ˌi
αμάθητος|a m ˈa θ i t ˌo s
αμάξια|a m ˈa k s i  ˌa
αμέ|a m ˈe
αμέλεια|a m ˈe ʎ a
αμέσως|a m ˈe s o s
αμέτρητες|a m ˈe t r i t ˌe s
αμαξάκι|ˌa m a k s ˈa c i
αμαρτία|ˌa m a r t ˈi  a
αμοιράκο|ˌa m i r ˈa k o
αμοιράκος|ˌa m i r ˈa k o s
αμοιράκου|ˌa m i r ˈa k u
αμπέλια|a b ˈe ʎ a
αμυγδαλιές|ˌa m i ɣ ð a ʎ ˈe s
αμόνι|a m ˈo n i
αν|ˈa n
ανάβαση»|a n ˈa v a s ˌi
ανάγκασε|a n ˈa ŋ ɡ a s ˌe
ανάγκες|a n ˈa ŋ ɡ e s
ανάδειξη|a n ˈa ð i k s ˌi
ανάλογο|a n ˈa l o ɣ ˌo
ανάμεσά|a n ˈa m e s ˈa
ανάμεσα|a n ˈa m e s ˌa
ανάπτυξης|a n ˈa p t i k s ˌi s
ανάσκελα|a n ˈa s c e l ˌa
ανάστατος|a n ˈa s t a t ˌo s
ανάψει|a n ˈa p s i
ανάψεις|a n ˈa p s i s
ανέβαινε|a n ˈe v e n ˌe
ανέβει|a n ˈe v i
ανέβηκα|a n ˈe v i k ˌa
ανέβηκαν|a n ˈe v i k ˌa n
ανέβηκε|a n ˈe v i c ˌe
ανέστησες|a n ˈe s t i s ˌe s
ανήγγειλε|a n ˈi ŋ ɡ i l ˌe
ανήξερο|a n ˈi k s e r ˌo
ανήσυχα|a n ˈi s i x ˌa
ανήσυχες|a n ˈi s i ç ˌe s
ανήφορο|a n ˈi f o r ˌo
αναίσθητο|a n ˈe s θ i t ˌo
αναίσθητος|a n ˈe s θ i t ˌo s
αναβάλει|ˌa n a v ˈa l i
αναγέννηση|ˌa n a j ˈe n i s ˌi
αναγκάζει|ˌa n a ŋ ɡ ˈa z i
αναγκάστηκαν|ˌa n a ŋ ɡ ˈa s t i k ˌa n
αναγκάστηκε|ˌa n a ŋ ɡ ˈa s t i c ˌe
αναγκαίος|ˌa n a ŋ ɡ ˈe o s
αναγνωρίζει|ˌa n a ɣ n o r ˈi z i
αναγνωρίζεις|ˌa n a ɣ n o r ˈi z i s
αναγνωρίζοντας|ˌa n a ɣ n o r ˈi z o d ˌa s
αναγνωρίσετε|ˌa n a ɣ n o r ˈi s e t ˌe
αναγνώριζε|ˌa n a ɣ n ˈo r i z ˌe
αναγνώρισε|ˌa n a ɣ n ˈo r i s ˌe
αναδασωτέα|ˌa n a ð ˌa s o t ˈe a
αναδιοργάνωση|ˌa n a ð ˌi  o r ɣ ˈa n o s ˌi
αναζήτησης|ˌa n a z ˈi t i s ˌi s
αναζητούσε|ˌa n a z i t ˈu s e
ανακάλυψε|ˌa n a k ˈa l i p s ˌe
ανακατώνοντας|ˌa n a k a t ˈo n o d ˌa s
ανακούρκουδα|ˌa n a k ˈu r k u ð ˌa
ανακούφιση|ˌa n a k ˈu f i s ˌi
αναλυμένο|ˌa n a l i m ˈe n o
αναμεταξύ|ˌa n a m ˌe t a k s ˈi
αναμμένο|ˌa n a m ˈe n o
αναμπαμπούλα|ˌa n a b a b ˈu l a
ανανέωσαν|ˌa n a n ˈe o s ˌa n
ανανδρία|ˌa n a n ð r ˈi  a
αναπήδησε|ˌa n a p ˈi ð i s ˌe
αναπαύτηκαν|ˌa n a p ˈa f t i k ˌa n
αναπληρώσει|ˌa n a p l i r ˈo s i
αναπληρώσω|ˌa n a p l i r ˈo s o
αναποδογυρίζοντας|ˌa n a p ˌo ð o j i r ˈi z o d ˌa s
αναποδογύρισε|ˌa n a p ˌo ð o j ˈi r i s ˌe
αναρρωτική|ˌa n a r ˌo t i c ˈi
ανασάνει|ˌa n a s ˈa n i
ανασάνεις|ˌa n a s ˈa n i s
ανασηκωθεί|ˌa n a s ˌi k o θ ˈi
ανασηκώθηκε|ˌa n a s i k ˈo θ i c ˌe
ανασηκώνουνταν|ˌa n a s i k ˈo n u d ˌa n
αναστέναξε|ˌa n a s t ˈe n a k s ˌe
αναστήθηκε|ˌa n a s t ˈi θ i c ˌe
αναστατωμένη|ˌa n a s t ˌa t o m ˈe n i
αναστατώσετε|ˌa n a s t a t ˈo s e t ˌe
αναστενάζοντας|ˌa n a s t e n ˈa z o d ˌa s
αναστεναγμό|ˌa n a s t ˌe n a ɣ m ˈo
ανατινάχθηκε|ˌa n a t i n ˈa x θ i c ˌe
ανατρίχιασαν|ˌa n a t r ˈi ç a s ˌa n
ανατρίχιασε|ˌa n a t r ˈi ç a s ˌe
ανατριχιάζοντας|ˌa n a t r i ç ˈa z o d ˌa s
αναφιλητά|ˌa n a f ˌi l i t ˈa
αναφιλητό|ˌa n a f ˌi l i t ˈo
αναφώνησε|ˌa n a f ˈo n i s ˌe
ανδρεία|a n ð r ˈi  a
ανεβάζουν|ˌa n e v ˈa z u n
ανεβαίνει|ˌa n e v ˈe n i
ανεβαίνοντας|ˌa n e v ˈe n o d ˌa s
ανεβείτε|ˌa n e v ˈi t e
ανεβοκατέβαιναν|ˌa n e v ˌo k a t ˈe v e n ˌa n
ανεβούν|ˌa n e v ˈu n
ανεκτίμητη|ˌa n e k t ˈi m i t ˌi
ανεμπόδιστοι|ˌa n e b ˈo ð i s t ˌi
ανενόχλητα|ˌa n e n ˈo x l i t ˌa
ανεψιέ|ˌa n e p s i  ˈe
ανεψιού|ˌa n e p s i  ˈu
ανεψιών|ˌa n e p s i  ˈo n
ανησυ|a n ˈi s i
ανησυχήσει|ˌa n i s i ç ˈi s i
ανησυχίες|ˌa n i s i ç ˈi  e s
ανθισμένα|ˌa n θ i s m ˈe n a
ανθισμένες|ˌa n θ i s m ˈe n e s
ανθρωπάκι|ˌa n θ r o p ˈa c i
ανθρώπινη|a n θ r ˈo p i n ˌi
ανθρώπινο|a n θ r ˈo p i n ˌo
ανθρώπου|a n θ r ˈo p u
ανθρώπους|a n θ r ˈo p u s
ανιχνευτή|ˌa n i x n e f t ˈi
ανοίγεις|a n ˈi j i s
ανοίγοντας|a n ˈi ɣ o d ˌa s
ανοίξει|a n ˈi k s i
ανοίξουν|a n ˈi k s u n
ανοίξω|a n ˈi k s o
ανοιξιάτικος|ˌa n i k s i  ˈa t i k ˌo s
ανοιχτά|ˌa n i x t ˈa
ανοιχτές|ˌa n i x t ˈe s
ανοιχτή|ˌa n i x t ˈi
ανοιχτό|ˌa n i x t ˈo
ανοιχτόκαρδο|ˌa n i x t ˈo k a r ð ˌo
ανοιχτός|ˌa n i x t ˈo s
αντάμωσα|a d ˈa m o s ˌa
αντάμωσαν|a d ˈa m o s ˌa n
αντάμωσε|a d ˈa m o s ˌe
αντάρα|a d ˈa r a
αντί|a d ˈi
αντίκριζε|a d ˈi k r i z ˌe
αντίκρυ|a d ˈi k r i
αντίς|a d ˈi s
αντίσταση|a d ˈi s t a s ˌi
αντίτιμο|a d ˈi t i m ˌo
ανταλλάξει|ˌa d a l ˈa k s i
ανταμώσουν|ˌa d a m ˈo s u n
ανταποδώσομε|ˌa d a p o ð ˈo s o m ˌe
ανταπόκριση|ˌa d a p ˈo k r i s ˌi
αντεκδικήσεις|ˌa d e k ð i c ˈi s i s
αντιδρούσε|ˌa d i ð r ˈu s e
αντικείμενα|ˌa d i c ˈi m e n ˌa
αντικρίσομε|ˌa d i k r ˈi s o m ˌe
αντικρίσουμε|ˌa d i k r ˈi s u m ˌe
αντικρινή|ˌa d i k r i n ˈi
αντικρινής|ˌa d i k r i n ˈi s
αντικρινό|ˌa d i k r i n ˈo
αντιλήφθηκαν|ˌa d i l ˈi f θ i k ˌa n
αντιλήφθηκε|ˌa d i l ˈi f θ i c ˌe
αντιληφθούν|ˌa d i l i f θ ˈu n
αντισταθεί|ˌa d i s t a θ ˈi
αντρίκεια|a d r ˈi c a
αντρίκειες|a d r ˈi c e s
αντρειωμένα|ˌa d r ç o m ˈe n a
ανυποψίαστοι|ˌa n i p o p s ˈi  a s t ˌi
ανόητη|a n ˈoɪ t i
ανώτερος|a n ˈo t e r ˌo s
αξία|a k s ˈi  a
αξίας|a k s ˈi  a s
αξίζουν|a k s ˈi z u n
αξίνα|a k s ˈi n a
αξίνες|a k s ˈi n e s
αξιοθρήνητο|ˌa k s i  o θ r ˈi n i t ˌo
αξιοθρήνητος|ˌa k s i  o θ r ˈi n i t ˌo s
αξιοποιηθούν|ˌa k s i  ˌo p i  i θ ˈu n
αξιοπρέπεια|ˌa k s i  o p r ˈe p ç a
αξιωματικοί|ˌa k s i  ˌo m a t i c ˈi
αξιωματικούς|ˌa k s i  ˌo m a t i k ˈu s
αξιώματος|ˌa k s i  ˈo m a t ˌo s
απ'|ˈa p
απάθεια|a p ˈa θ ç a
απάντησε|a p ˈa d i s ˌe
απάντηση|a p ˈa d i s ˌi
απάνω|a p ˈa n o
απέθανε|a p ˈe θ a n ˌe
απέραντα|a p ˈe r a d ˌa
απέραντες|a p ˈe r a d ˌe s
απέραντο|a p ˈe r a d ˌo
απέραντους|a p ˈe r a d ˌu s
απαίσιο|a p ˈe s j o
απαλό|ˌa p a l ˈo
απαντήσαμε|ˌa p a d ˈi s a m ˌe
απαντήσει|ˌa p a d ˈi s i
απαντήσεις|ˌa p a d ˈi s i s
απαραίτητη|ˌa p a r ˈe t i t ˌi
απαραίτητο|ˌa p a r ˈe t i t ˌo
απαρατήρητος|ˌa p a r a t ˈi r i t ˌo s
απεικονίζεται|ˌa p i k o n ˈi z e t ˌe
απειλητικά|ˌa p i l ˌi t i k ˈa
απελπίζουνταν|ˌa p e l p ˈi z u d ˌa n
απελπισμένος|ˌa p e l p i s m ˈe n o s
απεναντίας|ˌa p e n a d ˈi  a s
απεριποίητο|ˌa p e r i p ˈi  i t ˌo
απεσταλμέ|ˌa p e s t a l m ˈe
απεσταλμένο|ˌa p e s t a l m ˈe n o
απεσταλμένοι|ˌa p e s t a l m ˈe n i
απεσταλμένος|ˌa p e s t a l m ˈe n o s
απλά|a p l ˈa
απλήρωτα|a p l ˈi r o t ˌa
απλωθεί|ˌa p l o θ ˈi
απλωμένο|ˌa p l o m ˈe n o
απλωμένος|ˌa p l o m ˈe n o s
απλό|a p l ˈo
απλώθηκε|a p l ˈo θ i c ˌe
απλώνονται|a p l ˈo n o d ˌe
απλώνοντας|a p l ˈo n o d ˌa s
απλώνουνταν|a p l ˈo n u d ˌa n
αποβλακωμένο|ˌa p o v l ˌa k o m ˈe n o
αποθήκες|ˌa p o θ ˈi c e s
αποθήκη|ˌa p o θ ˈi c i
αποθαρρυμένο|ˌa p o θ ˌa r i m ˈe n o
αποθαρρυμένος|ˌa p o θ ˌa r i m ˈe n o s
αποκάτω|ˌa p o k ˈa t o
αποκαίουνταν|ˌa p o c ˈe u d ˌa n
αποκαλυψεις|ˌa p o k a l ˈi p s i s
αποκαμωμένοι|ˌa p o k ˌa m o m ˈe n i
αποκαμωμένος|ˌa p o k ˌa m o m ˈe n o s
αποκοιμήθηκαν|ˌa p o c i m ˈi θ i k ˌa n
αποκοιμήθηκε|ˌa p o c i m ˈi θ i c ˌe
αποκοιμηθεί|ˌa p o c ˌi m i θ ˈi
αποκρίθηκα|ˌa p o k r ˈi θ i k ˌa
αποκρίθηκαν|ˌa p o k r ˈi θ i k ˌa n
αποκρίθηκε|ˌa p o k r ˈi θ i c ˌe
αποκρίθηκες|ˌa p o k r ˈi θ i c ˌe s
αποκρίνεται|ˌa p o k r ˈi n e t ˌe
αποκρίνουνταν|ˌa p o k r ˈi n u d ˌa n
αποκριθεί|ˌa p o k r i θ ˈi
αποκτάς|ˌa p o k t ˈa s
απολαβή|ˌa p o l a v ˈi
απολογήθηκε|ˌa p o l o j ˈi θ i c ˌe
απομάκρυνε|ˌa p o m ˈa k r i n ˌe
απομακρυνθεί|ˌa p o m ˌa k r i n θ ˈi
αποπήρε|ˌa p o p ˈi r e
απορία|ˌa p o r ˈi  a
αποστάσω|ˌa p o s t ˈa s o
αποσταλμένους|ˌa p o s t a l m ˈe n u s
αποτραβηχθεί|ˌa p o t r ˌa v i x θ ˈi
αποτραβηχτεί|ˌa p o t r ˌa v i x t ˈi
απουσιάζει|ˌa p u s j ˈa z i
αποφάσισαν|ˌa p o f ˈa s i s ˌa n
αποφάσισε|ˌa p o f ˈa s i s ˌe
αποφασίσει|ˌa p o f a s ˈi s i
αποφασιστικά|ˌa p o f ˌa s i s t i k ˈa
αποχαιρέτησαν|ˌa p o ç e r ˈe t i s ˌa n
αποχαιρέτησε|ˌa p o ç e r ˈe t i s ˌe
αποχαιρετήσει|ˌa p o ç ˌe r e t ˈi s i
αποχαιρετήσουν|ˌa p o ç ˌe r e t ˈi s u n
αποχαιρετισμό|ˌa p o ç ˌe r e t i s m ˈo
αποχαυνώσεως|ˌa p o x a v n ˈo s e ˌo s
από|a p ˈo
απόβλητος|a p ˈo v l i t ˌo s
απόγεμα|a p ˈo j e m ˌa
απόντα|a p ˈo d a
απόρησε|a p ˈo r i s ˌe
απότομα|a p ˈo t o m ˌa
απόφαση|a p ˈo f a s ˌi
απόψε|a p ˈo p s e
απών|a p ˈo n
απ’|ˈa p
αρέσει|a r ˈe s i
αρέσουν|a r ˈe s u n
αργά|a r ɣ ˈa
αργήσω|a r j ˈi s o
αργοκούνησε|ˌa r ɣ o k ˈu n i s ˌe
αργοσαλεύει|ˌa r ɣ o s a l ˈe v i
αργότερα|a r ɣ ˈo t e r ˌa
αρθρώσει|a r θ r ˈo s i
αριστερά|ˌa r i s t e r ˈa
αριστερή|ˌa r i s t e r ˈi
αριστερό|ˌa r i s t e r ˈo
αρκέσει|a r c ˈe s i
αρκετά|ˌa r c e t ˈa
αρκετή|ˌa r c e t ˈi
αρκετό|ˌa r c e t ˈo
αρκούσε|a r k ˈu s e
αρμάτωσε|a r m ˈa t o s ˌe
αρμέγεις|a r m ˈe j i s
αρμέξει|a r m ˈe k s i
αρμέξουν|a r m ˈe k s u n
αρματωμένοι|ˌa r m a t o m ˈe n i
αρνητικά|ˌa r n i t i k ˈa
αρνιά|a r ɲ ˈa
αρνιά·|a r ɲ ˈa
αρπάζοντας|a r p ˈa z o d ˌa s
αρπάξει|a r p ˈa k s i
αρπάξουν|a r p ˈa k s u n
αρραβώνες|ˌa r a v ˈo n e s
αρρωστήσει|ˌa r o s t ˈi s i
αρρώστησε|a r ˈo s t i s ˌe
αρχές|a r ç ˈe s
αρχή|a r ç ˈi
αρχίζει|a r ç ˈi z i
αρχίσει|a r ç ˈi s i
αρχίσομε|a r ç ˈi s o m ˌe
αρχίσουν|a r ç ˈi s u n
αρχίσω|a r ç ˈi s o
αρχηγό|ˌa r ç i ɣ ˈo
αρχηγός|ˌa r ç i ɣ ˈo s
αρχι|ˈa r ç i
αρχικαγκελάριο|ˌa r ç i k ˌa ŋ ɡ e l ˈa r i  ˌo
αρχικαγκελάριοι|ˌa r ç i k ˌa ŋ ɡ e l ˈa r i  ˌi
αρχικαγκελάριος|ˌa r ç i k ˌa ŋ ɡ e l ˈa r i  ˌo s
αρχικαγκελάριου|ˌa r ç i k ˌa ŋ ɡ e l ˈa r i  ˌu
αρχικαγκελάριό|ˌa r ç i k ˌa ŋ ɡ e l ˈa r i  ˈo
αρχικαγκελάριός|ˌa r ç i k ˌa ŋ ɡ e l ˈa r i  ˈo s
αρχικελάρη|ˌa r ç i c e l ˈa r i
αρχικελάρης|ˌa r ç i c e l ˈa r i s
αρχικό|ˌa r ç i k ˈo
αρχιμαστόρους|ˌa r ç i m a s t ˈo r u s
αρχιστράτηγο|ˌa r ç i s t r ˈa t i ɣ ˌo
αρχιστράτηγοι|ˌa r ç i s t r ˈa t i j ˌi
αρχιστράτηγος|ˌa r ç i s t r ˈa t i ɣ ˌo s
αρχιστράτηγου|ˌa r ç i s t r ˈa t i ɣ ˌu
αρχιτραπεζιέρη|ˌa r ç i t r ˌa p e z j ˈe r i
αρχοντάνθρωπος|ˌa r x o d ˈa n θ r o p ˌo s
αρχοντα|a r x ˈo d a
αρχοντιά|ˌa r x o d i  ˈa
αρχοντόπουλά|ˌa r x o d ˈo p u l ˈa
αρχοντόπουλα|ˌa r x o d ˈo p u l ˌa
αρχοντόπουλο|ˌa r x o d ˈo p u l ˌo
αρχόντων|a r x ˈo d o n
ας|ˈa s
ασημένια|ˌa s i m ˈe ɲ a
ασημένιο|ˌa s i m ˈe ɲ o
ασθενή|ˌa s θ e n ˈi
ασθενείς|ˌa s θ e n ˈi s
ασθενών|ˌa s θ e n ˈo n
ασπρισμένα·|ˌa s p r i s m ˈe n a
αστεία|a s t ˈi  a
αστείος|a s t ˈi  o s
αστραπή|ˌa s t r a p ˈi
αστόχαστο|a s t ˈo x a s t ˌo
αστόχαστος|a s t ˈo x a s t ˌo s
αστόχαστου|a s t ˈo x a s t ˌu
ασυλλόγιστα|ˌa s i l ˈo j i s t ˌa
ασυνήθιστο|ˌa s i n ˈi θ i s t ˌo
ασυνείδητο|ˌa s i n ˈi ð i t ˌo
ασφάλεια|a s f ˈa ʎ a
ασχήμια|a s ç ˈi m i  ˌa
ατάραχα|a t ˈa r a x ˌa
ατάραχο|a t ˈa r a x ˌo
ατάραχος|a t ˈa r a x ˌo s
ατέλειωτες|a t ˈe ʎ o t ˌe s
ατίμητα|a t ˈi m i t ˌa
αταξία|ˌa t a k s ˈi  a
αταραξία|ˌa t a r a k s ˈi  a
ατιμίες|ˌa t i m ˈi  e s
ατρόμητος|a t r ˈo m i t ˌo s
ατυχία|ˌa t i ç ˈi  a
αυγά|a v ɣ ˈa
αυγή|a v j ˈi
αυθάδεις|a f θ ˈa ð i s
αυθάδη|a f θ ˈa ð i
αυθάδης|a f θ ˈa ð i s
αυθόρμητα|a f θ ˈo r m i t ˌa
αυξήσομε|a f k s ˈi s o m ˌe
αυριανός|ˌa v r i  a n ˈo s
αυστηρά|ˌa f s t i r ˈa
αυτά|a f t ˈa
αυτές|a f t ˈe s
αυτής|a f t ˈi s
αυτιά|ˌa f t i  ˈa
αυτοί|a f t ˈi
αυτοθυσία|ˌa f t o θ i s ˈi  a
αυτουνού|ˌa f t u n ˈu
αυτού|a f t ˈu
αυτούς|a f t ˈu s
αυτόν|a f t ˈo n
αυτός|a f t ˈo s
αφέγγαρης|a f ˈe ŋ ɡ a r ˌi s
αφέντη|a f ˈe d i
αφέντης|a f ˈe d i s
αφήνει|a f ˈi n i
αφήνεις|a f ˈi n i s
αφήνοντας|a f ˈi n o d ˌa s
αφήνουν|a f ˈi n u n
αφήσει|a f ˈi s i
αφήσεις|a f ˈi s i s
αφήσουν|a f ˈi s u n
αφανέρωτο|ˌa f a n ˈe r o t ˌo
αφανισμένος|ˌa f a n i s m ˈe n o s
αφεντάδες|ˌa f e d ˈa ð e s
αφεντιά|ˌa f e d i  ˈa
αφεντιάς|ˌa f e d i  ˈa s
αφηρημένα|ˌa f i r i m ˈe n a
αφιλόξενο|ˌa f i l ˈo k s e n ˌo
αφοσιωμένοι|ˌa f o s j o m ˈe n i
αφοσιώσεως|ˌa f o s j ˈo s e ˌo s
αφού|a f ˈu
αφρισμένος|ˌa f r i s m ˈe n o s
αφότου|a f ˈo t u
αχ|ˈa x
αχαλίνωτου|ˌa x a l ˈi n o t ˌu
αχλαδιές|ˌa x l a ð i  ˈe s
αχτίδες|a x t ˈi ð e s
αχτινοβολούσαν|ˌa x t i n ˌo v o l ˈu s a n
αψηφώντας|ˌa p s i f ˈo d a s
αύριο|ˈa v r i  ˌo
β'|v ˈi t a
βάζεις|v ˈa z i s
βάζοντας|v ˈa z o d ˌa s
βάθος|v ˈa θ o s
βάλανε|v ˈa l a n ˌe
βάλεις|v ˈa l i s
βάλθηκε|v ˈa l θ i c ˌe
βάλτε|v ˈa l t e
βάραθρο|v ˈa r a θ r ˌo
βάρη|v ˈa r i
βάρκα|v ˈa r k a
βάρκες|v ˈa r c e s
βάσανα|v ˈa s a n ˌa
βάση|v ˈa s i
βάτος|v ˈa t o s
βέβαια|v ˈe v e ˌa
βέβαιος|v ˈe v e ˌo s
βέλη|v ˈe l i
βέλος|v ˈe l o s
βέρνας|v ˈe r n a s
βήμα|v ˈi m a
βήματα|v ˈi m a t ˌa
βία|v ˈi  a
βαθούλωμα|v a θ ˈu l o m ˌa
βαθύ|v a θ ˈi
βαλανιδιά|v ˌa l a n ˌi ð i  ˈa
βαλανιδιάς|v ˌa l a n ˌi ð i  ˈa s
βαμμένα|v a m ˈe n a
βαρέθηκα|v a r ˈe θ i k ˌa
βαρέθηκε|v a r ˈe θ i c ˌe
βαρεθεί|v ˌa r e θ ˈi
βαρελόμορφη|v ˌa r e l ˈo m o r f ˌi
βαριά|v ˌa r i  ˈa
βαριεστημένος|v ˌa r i  ˌe s t i m ˈe n o s
βαριούμαι|v ˌa r i  ˈu m e
βαριόταν|v ˌa r i  ˈo t a n
βαρκάρη|v a r k ˈa r i
βαρύ|v a r ˈi
βαρύς|v a r ˈi s
βασίλεια|v a s ˈi ʎ a
βασίλειο|v a s ˈi ʎ o
βασίλειο·|v a s ˈi ʎ o
βασίλειό|v a s ˈi ʎ ˈo
βασίλισσά|v a s ˈi l i s s ˈa
βασίλισσα|v a s ˈi l i s s ˌa
βασίλισσας|v a s ˈi l i s s ˌa s
βασανίζουνταν|v ˌa s a n ˈi z u d ˌa n
βασιλέψει|v ˌa s i l ˈe p s i
βασιλείου|v ˌa s i l ˈi  u
βασιλιά|v ˌa s i ʎ ˈa
βασιλιάδες|v ˌa s i ʎ ˈa ð e s
βασιλιάς|v ˌa s i ʎ ˈa s
βασιλια|v a s ˈi ʎ a
βασιλιας|v a s ˈi ʎ a s
βασιλικά|v ˌa s i l i k ˈa
βασιλικούς|v ˌa s i l i k ˈu s
βασιλικό|v ˌa s i l i k ˈo
βασιλικός|v ˌa s i l i k ˈo s
βασιλοπούλα|v ˌa s i l o p ˈu l a
βασιλοπούλας|v ˌa s i l o p ˈu l a s
βασιλοπούλες|v ˌa s i l o p ˈu l e s
βασιλόπουλ|v ˌa s i l ˈo p u l
βασιλόπουλο|v ˌa s i l ˈo p u l ˌo
βασιλόπουλου|v ˌa s i l ˈo p u l ˌu
βαστά|v a s t ˈa
βαστάξει|v a s t ˈa k s i
βαστάχτηκε|v a s t ˈa x t i c ˌe
βασταγμένες|v ˌa s t a ɣ m ˈe n e s
βαστιούνταν|v ˌa s t i  ˈu d a n
βαστούν|v a s t ˈu n
βαστούσα|v a s t ˈu s a
βαστούσαν|v a s t ˈu s a n
βαστούσε|v a s t ˈu s e
βαστώντας|v a s t ˈo d a s
βατομουριά|v ˌa t o m ˌu r i  ˈa
βατομουριές|v ˌa t o m ˌu r i  ˈe s
βατόμουρα|v a t ˈo m u r ˌa
βγάζαμε|v ɣ ˈa z a m ˌe
βγάζομε|v ɣ ˈa z o m ˌe
βγάζοντας|v ɣ ˈa z o d ˌa s
βγάζουν|v ɣ ˈa z u n
βγάλε|v ɣ ˈa l e
βγάλει|v ɣ ˈa l i
βγάλεις|v ɣ ˈa l i s
βγάλτε|v ɣ ˈa l t e
βγάλω|v ɣ ˈa l o
βγήκα|v j ˈi k a
βγήκαν|v j ˈi k a n
βγήκε|v j ˈi c e
βγαίνεις|v j ˈe n i s
βγαίνοντας|v j ˈe n o d ˌa s
βγει|v j ˈi
βγουν|v ɣ ˈu n
βγούμε|v ɣ ˈu m e
βεβαιωθεί|v ˌe v e o θ ˈi
βεβαιωθείς|v ˌe v e o θ ˈi s
βεβαιωθούν|v ˌe v e o θ ˈu n
βελουδένια|v ˌe l u ð ˈe ɲ a
βελουδένιο|v ˌe l u ð ˈe ɲ o
βελόνες|v e l ˈo n e s
βημάτων|v i m ˈa t o n
βιάζεσαι|v i  ˈa z e s ˌe
βιαζόταν|v ˌi  a z ˈo t a n
βιαστικά|v ˌi  a s t i k ˈa
βιαστική|v ˌi  a s t i c ˈi
βιαστικό|v ˌi  a s t i k ˈo
βιαστικός|v ˌi  a s t i k ˈo s
βιβλία|v i v l ˈi  a
βιβλίο|v i v l ˈi  o
βιολογικά|v ˌi  o l ˌo j i k ˈa
βιταμίνη|v ˌi t a m ˈi n i
βλάκα|v l ˈa k a
βλάκας|v l ˈa k a s
βλάστηση|v l ˈa s t i s ˌi
βλάψουν|v l ˈa p s u n
βλέμμα|v l ˈe m a
βλέπει|v l ˈe p i
βλέπεις|v l ˈe p i s
βλέπετε|v l ˈe p e t ˌe
βλέπομε|v l ˈe p o m ˌe
βλέποντας|v l ˈe p o d ˌa s
βλέπω|v l ˈe p o
βλαστήμησε|v l a s t ˈi m i s ˌe
βοήθεια|v o ˈi θ ç a
βοηθάει|v oɪ θ ˈa i
βοηθήσει|v oɪ θ ˈi s i
βοηθήσεις|v oɪ θ ˈi s i s
βοηθήσετε|v oɪ θ ˈi s e t ˌe
βοηθήσω|v oɪ θ ˈi s o
βοηθούσε|v oɪ θ ˈu s e
βου|v ˈu
βουβά|v u v ˈa
βουβάθηκε|v u v ˈa θ i c ˌe
βουνά|v u n ˈa
βουνού|v u n ˈu
βουνού»|v u n ˈu
βουνό|v u n ˈo
βουρκωμένα|v ˌu r k o m ˈe n a
βουτήξει|v u t ˈi k s i
βουτήσει|v u t ˈi s i
βουτώντας|v u t ˈo d a s
βούιζε|v ˈu i z ˌe
βούκινο|v ˈu c i n ˌo
βούλα|v ˈu l a
βούρκωναν|v ˈu r k o n ˌa n
βούρλο|v ˈu r l o
βούτυρο|v ˈu t i r ˌo
βράζει|v r ˈa z i
βράζεις|v r ˈa z i s
βράσω|v r ˈa s o
βράχο|v r ˈa x o
βράχοι|v r ˈa ç i
βράχου|v r ˈa x u
βράχους|v r ˈa x u s
βρέθηκαν|v r ˈe θ i k ˌa n
βρέθηκε|v r ˈe θ i c ˌe
βρέθηκες|v r ˈe θ i c ˌe s
βρέχει|v r ˈe ç i
βρήκα|v r ˈi k a
βρήκαμε|v r ˈi k a m ˌe
βρήκες|v r ˈi c e s
βρίζει|v r ˈi z i
βρίζουν|v r ˈi z u n
βρίσει|v r ˈi s i
βρίσκαμε|v r ˈi s k a m ˌe
βρίσκει|v r ˈi s c i
βρίσκεις|v r ˈi s c i s
βρίσκεται|v r ˈi s c e t ˌe
βρίσκονται|v r ˈi s k o d ˌe
βρίσκονταν|v r ˈi s k o d ˌa n
βρίσκουν|v r ˈi s k u n
βρίσκουνταν|v r ˈi s k u d ˌa n
βραδιάσει|v r ˌa ð i  ˈa s i
βραδινό|v r ˌa ð i n ˈo
βραστό|v r a s t ˈo
βραχιόλι|v r a ç ˈo l i
βραχνή|v r a x n ˈi
βρεθεί|v r e θ ˈi
βρεθούν|v r e θ ˈu n
βρεις|v r ˈi s
βρεχτοκούκια|v r ˌe x t o k ˈu c a
βρισιές|v r i s j ˈe s
βρισκόταν|v r i s k ˈo t a n
βροντά|v r o d ˈa
βροντοφώνησε|v r ˌo d o f ˈo n i s ˌe
βροντόφωνα|v r o d ˈo f o n ˌa
βρουν|v r ˈu n
βροχές|v r o ç ˈe s
βροχή|v r o ç ˈi
βρω|v r ˈo
βρόντος|v r ˈo d o s
βρώμικα|v r ˈo m i k ˌa
βρώμικο|v r ˈo m i k ˌo
βρώμικους|v r ˈo m i k ˌu s
βυσσινί|v ˌi s s i n ˈi
βόλτες|v ˈo l t e s
βώδια|v ˈo ð j a
γ'|ɣ ˈa m a
γάλα|ɣ ˈa l a
γάμος|ɣ ˈa m o s
γάτα|ɣ ˈa t a
γέλασα|j ˈe l a s ˌa
γέλασαν|j ˈe l a s ˌa n
γέλασε|j ˈe l a s ˌe
γέλια|j ˈe ʎ a
γέλιο|j ˈe ʎ o
γέμιζαν|j ˈe m i z ˌa n
γέμιζε|j ˈe m i z ˌe
γέμισα|j ˈe m i s ˌa
γέμισαν|j ˈe m i s ˌa n
γέμισε|j ˈe m i s ˌe
γέρο|j ˈe r o
γέροι|j ˈe r i
γέρος|j ˈe r o s
γέρους|j ˈe r u s
γέφυρας|j ˈe f i r ˌa s
γίνει|j ˈi n i
γίνεις|j ˈi n i s
γίνεται|j ˈi n e t ˌe
γίνηκαν|j ˈi n i k ˌa n
γίνηκε|j ˈi n i c ˌe
γίνομε|j ˈi n o m ˌe
γίνονται|j ˈi n o d ˌe
γίνονταν|j ˈi n o d ˌa n
γίνουμε|j ˈi n u m ˌe
γίνουν|j ˈi n u n
γίνουνταν|j ˈi n u d ˌa n
γίνω|j ˈi n o
γα|ɣ ˈa
γαβάθα|ɣ a v ˈa θ a
γαλόπουλο|ɣ a l ˈo p u l ˌo
γαμπρό|ɣ a b r ˈo
γαμπρός|ɣ a b r ˈo s
γαϊδουρίσιο|ɣ ˌaɪ ð u r ˈi s j o
γείρει|j ˈi r i
γείτονας|j ˈi t o n ˌa s
γείτονες|j ˈi t o n ˌe s
γειτονιά|j ˌi t o ɲ ˈa
γειτονικά|j ˌi t o n i k ˈa
γειτονικού|j ˌi t o n i k ˈu
γειτονικό|j ˌi t o n i k ˈo
γελαστά|j ˌe l a s t ˈa
γελαστές|j ˌe l a s t ˈe s
γελαστή|j ˌe l a s t ˈi
γελούσε|j e l ˈu s e
γελώντας|j e l ˈo d a s
γεμάτα|j e m ˈa t a
γεμάτες|j e m ˈa t e s
γεμάτη|j e m ˈa t i
γεμάτο|j e m ˈa t o
γεμάτος|j e m ˈa t o s
γεμίζουν|j e m ˈi z u n
γεμίσουν|j e m ˈi s u n
γενικά|j ˌe n i k ˈa
γενική|j ˌe n i c ˈi
γενικής|j ˌe n i c ˈi s
γενικό|j ˌe n i k ˈo
γεννήθηκα|j e n ˈi θ i k ˌa
γεννήματα|j e n ˈi m a t ˌa
γενναία|j e n ˈe a
γεννηθεί|j ˌe n i θ ˈi
γεννιούνται|j e ɲ ˈu d e
γερά|j e r ˈa
γερή|j e r ˈi
γερμένη|j e r m ˈe n i
γερο|j ˈe r o
γεροντάκι|j ˌe r o d ˈa c i
γερό|j e r ˈo
γευθείτε|j i θ ˈi t e
γεφύρι|j e f ˈi r i
γεωργικών|j ˌo r j i k ˈo n
γεωργοί|j o r j ˈi
γεύση|j ˈi s i
γη|j ˈi
γης|j ˈi s
γι'|j ˈi
γιάνει|j ˈa n i
γιάτρεψε|j ˈa t r e p s ˌe
για|j ˈa
γιαγιάς|j a j ˈa s
γιατρέψει|j a t r ˈe p s i
γιατρικό|j ˌa t r i k ˈo
γιατρός|j a t r ˈo s
γιαχνί|j a x n ˈi
γιε|j ˈe
γιο|j ˈo
γιος|j ˈo s
γιου|j ˈu
γιόκα|j ˈo k a
γιόκας|j ˈo k a s
γιός|j ˈo s
γι’|j ˈi
γκρέμισαν|ɡ r ˈe m i s ˌa n
γκρέμισε|ɡ r ˈe m i s ˌe
γκρεμίσει|ɡ r e m ˈi s i
γκρεμίστηκε|ɡ r e m ˈi s t i c ˌe
γκρεμισμένο|ɡ r ˌe m i s m ˈe n o
γκρεμιστείτε|ɡ r ˌe m i s t ˈi t e
γκρεμνού|ɡ r e m n ˈu
γκρεμνούς|ɡ r e m n ˈu s
γκρεμνό|ɡ r e m n ˈo
γκρεμό|ɡ r e m ˈo
γλίτωσαν|ɣ l ˈi t o s ˌa n
γλιστρώντας|ɣ l i s t r ˈo d a s
γλιτώσει|ɣ l i t ˈo s i
γλιτώσεις|ɣ l i t ˈo s i s
γλιτώσω|ɣ l i t ˈo s o
γλυκά|ɣ l i k ˈa
γλυκάνω|ɣ l i k ˈa n o
γλυκιά|ɣ l i c ˈa
γλυκοχαράζει|ɣ l ˌi k o x a r ˈa z i
γλύκα|ɣ l ˈi k a
γνωρίσει|ɣ n o r ˈi s i
γνωρίσω|ɣ n o r ˈi s o
γνώμη|ɣ n ˈo m i
γνώριζε|ɣ n ˈo r i z ˌe
γνώρισε|ɣ n ˈo r i s ˌe
γνώσης|ɣ n ˈo s i s
γονάτισαν|ɣ o n ˈa t i s ˌa n
γονάτισε|ɣ o n ˈa t i s ˌe
γονατίζοντας|ɣ ˌo n a t ˈi z o d ˌa s
γονατισμένη|ɣ ˌo n a t i s m ˈe n i
γονατισμένο|ɣ ˌo n a t i s m ˈe n o
γονατισμένον|ɣ ˌo n a t i s m ˈe n o n
γονατισμένος|ɣ ˌo n a t i s m ˈe n o s
γονατισμένου|ɣ ˌo n a t i s m ˈe n u
γονατιστός|ɣ ˌo n a t i s t ˈo s
γοργά|ɣ o r ɣ ˈa
γοργοπόδαρη|ɣ ˌo r ɣ o p ˈo ð a r ˌi
γουρλωμένα|ɣ ˌu r l o m ˈe n a
γράμμα|ɣ r ˈa m a
γράμματα|ɣ r ˈa m a t ˌa
γράφε|ɣ r ˈa f e
γράφει|ɣ r ˈa f i
γράφετε|ɣ r ˈa f e t ˌe
γράψει|ɣ r ˈa p s i
γρήγορα|ɣ r ˈi ɣ o r ˌa
γρήγορο|ɣ r ˈi ɣ o r ˌo
γρήγορος|ɣ r ˈi ɣ o r ˌo s
γραμμένα|ɣ r a m ˈe n a
γραμμένη|ɣ r a m ˈe n i
γραμμένο|ɣ r a m ˈe n o
γραμμή|ɣ r a m ˈi
γραμματάκια|ɣ r ˌa m a t ˈa c a
γραμματέα|ɣ r ˌa m a t ˈe a
γραμματέας|ɣ r ˌa m a t ˈe a s
γραμματικής|ɣ r ˌa m a t i c ˈi s
γρασίδι|ɣ r a s ˈi ð i
γρηγοράδα|ɣ r ˌi ɣ o r ˈa ð a
γρηγορώτερα|ɣ r ˌi ɣ o r ˈo t e r ˌa
γριάς|ɣ r i  ˈa s
γριούλα|ɣ r i  ˈu l a
γρόθο|ɣ r ˈo θ o
γυάλιζαν|j ˈa l i z ˌa n
γυάλιζε|j ˈa l i z ˌe
γυαλάκια|j a l ˈa c a
γυαλιστερά|j ˌa l i s t e r ˈa
γυμνά|j i m n ˈa
γυμνές|j i m n ˈe s
γυμνή|j i m n ˈi
γυμνασμένων|j ˌi m n a s m ˈe n o n
γυμνούς|j i m n ˈu s
γυναίκα|j i n ˈe k a
γυναίκες|j i n ˈe c e s
γυναικεία|j ˌi n e c ˈi  a
γυναικείες|j ˌi n e c ˈi  e s
γυρέψει|j i r ˈe p s i
γυρέψομε|j i r ˈe p s o m ˌe
γυρίζεις|j i r ˈi z i s
γυρίζοντας|j i r ˈi z o d ˌa s
γυρίσει|j i r ˈi s i
γυρίσεις|j i r ˈi s i s
γυρίσουν|j i r ˈi s u n
γυρίσω|j i r ˈi s o
γυρεύει|j i r ˈe v i
γυρεύεις|j i r ˈe v i s
γυρεύετε|j i r ˈe v e t ˌe
γυρεύομε|j i r ˈe v o m ˌe
γυρεύοντας|j i r ˈe v o d ˌa s
γυρισμένη|j ˌi r i s m ˈe n i
γυρισμο|j i r ˈi s m o
γυρισμό|j ˌi r i s m ˈo
γυρνά|j i r n ˈa
γυρνάς|j i r n ˈa s
γυρνάτε|j i r n ˈa t e
γυρνούσες|j i r n ˈu s e s
γυρνώντας|j i r n ˈo d a s
γωνία|ɣ o n ˈi  a
γωνίτσα|ɣ o n ˈi ts a
γωνιά|ɣ o ɲ ˈa
γωνιάς|ɣ o ɲ ˈa s
γωνιές|ɣ o ɲ ˈe s
γόνατά|ɣ ˈo n a t ˈa
γόνατα|ɣ ˈo n a t ˌa
γύμναζε|j ˈi m n a z ˌe
γύρευα|j ˈi r e v ˌa
γύρευαν|j ˈi r e v ˌa n
γύρευε|j ˈi r e v ˌe
γύριζα|j ˈi r i z ˌa
γύριζαν|j ˈi r i z ˌa n
γύριζε|j ˈi r i z ˌe
γύρισαν|j ˈi r i s ˌa n
γύρισε|j ˈi r i s ˌe
γύρισες|j ˈi r i s ˌe s
γύρισμα|j ˈi r i s m ˌa
γύρο|j ˈi r o
γύρους|j ˈi r u s
γύρω|j ˈi r o
δ'|ð ˈe l t a
δά|ð ˈa
δάγκωσε|ð ˈa ŋ ɡ o s ˌe
δάκρυ|ð ˈa k r i
δάκρυα|ð ˈa k r i  ˌa
δάση|ð ˈa s i
δάσκαλε|ð ˈa s k a l ˌe
δάσκαλο|ð ˈa s k a l ˌo
δάσκαλος|ð ˈa s k a l ˌo s
δάσος|ð ˈa s o s
δάσους|ð ˈa s u s
δάφνης|ð ˈa f n i s
δάχτυλα|ð ˈa x t i l ˌa
δάχτυλο|ð ˈa x t i l ˌo
δέ|ð ˈe
δέθηκε|ð ˈe θ i c ˌe
δέκα|ð ˈe k a
δέμα|ð ˈe m a
δέντρα|ð ˈe d r a
δέντρο|ð ˈe d r o
δέντρου|ð ˈe d r u
δέντρων|ð ˈe d r o n
δέσατε|ð ˈe s a t ˌe
δέσε|ð ˈe s e
δέσει|ð ˈe s i
δέσομε|ð ˈe s o m ˌe
δέσποζε|ð ˈe s p o z ˌe
δέχεσαι|ð ˈe ç e s ˌe
δέχεται|ð ˈe ç e t ˌe
δέχθηκαν|ð ˈe x θ i k ˌa n
δέχθηκε|ð ˈe x θ i c ˌe
δήμου|ð ˈi m u
δίκαιο|ð ˈi c e ˌo
δίκες|ð ˈi c e s
δίκη|ð ˈi c i
δίκιο|ð ˈi c o
δίνει|ð ˈi n i
δίνεις|ð ˈi n i s
δίνοντας|ð ˈi n o d ˌa s
δίνουν|ð ˈi n u n
δίπλωμα|ð ˈi p l o m ˌa
δίπλωσε|ð ˈi p l o s ˌe
δίστασε|ð ˈi s t a s ˌe
δίχτυα|ð ˈi x t i  ˌa
δα|ð ˈa
δαδί|ð a ð ˈi
δαιμονισμένο|ð ˌe m o n i s m ˈe n o
δαμάσομε|ð a m ˈa s o m ˌe
δαρθήκαμε|ð a r θ ˈi k a m ˌe
δασαρχείου|ð ˌa s a r ç ˈi  u
δασικού|ð ˌa s i k ˈu
δασκάλου|ð a s k ˈa l u
δασωμένα|ð ˌa s o m ˈe n a
δασωμένες|ð ˌa s o m ˈe n e s
δε|ð ˈe
δείξε|ð ˈi k s e
δείξει|ð ˈi k s i
δείξομε|ð ˈi k s o m ˌe
δείξω|ð ˈi k s o
δείπνησα|ð ˈi p n i s ˌa
δείρετε|ð ˈi r e t ˌe
δείρουν|ð ˈi r u n
δείτε|ð ˈi t e
δείχνοντας|ð ˈi x n o d ˌa s
δει|ð ˈi
δειλά|ð i l ˈa
δειλέ|ð i l ˈe
δειλιάζουν|ð i ʎ ˈa z u n
δειλιάσεις|ð i ʎ ˈa s i s
δειλοί|ð i l ˈi
δειλό|ð i l ˈo
δεινοσαύρους|ð ˌi n o s ˈa v r u s
δειπνήσει|ð i p n ˈi s i
δεις|ð ˈi s
δεκάξι|ð e k ˈa k s i
δεμένα|ð e m ˈe n a
δεμένες|ð e m ˈe n e s
δεμένο|ð e m ˈe n o
δεμένους|ð e m ˈe n u s
δεν|ð ˈe n
δεντροκουφάλα|ð ˌe d r o k u f ˈa l a
δεντροκουφάλες|ð ˌe d r o k u f ˈa l e s
δεξί|ð e k s ˈi
δεξιά|ð ˌe k s i  ˈa
δες|ð ˈe s
δεσμοφύλακα|ð ˌe s m o f ˈi l a k ˌa
δεσμοφύλακας|ð ˌe s m o f ˈi l a k ˌa s
δεσπόζοντας|ð e s p ˈo z o d ˌa s
δεσπότη|ð e s p ˈo t i
δευτέρου|ð e f t ˈe r u
δεχθείς|ð e x θ ˈi s
δεχθώ|ð e x θ ˈo
δεχόμαστε|ð e x ˈo m a s t ˌe
δεύτερη|ð ˈe f t e r ˌi
δεύτερο|ð ˈe f t e r ˌo
δημοσίευσή|ð ˌi m o s ˈi  e f s ˈi
δημόσια|ð i m ˈo s j a
διάβαζε|ð i  ˈa v a z ˌe
διάβαινε|ð i  ˈa v e n ˌe
διάβασε|ð i  ˈa v a s ˌe
διάβασμα|ð i  ˈa v a s m ˌa
διάβολο|ð i  ˈa v o l ˌo
διάγραμμα|ð i  ˈa ɣ r a m ˌa
διάδρομο|ð i  ˈa ð r o m ˌo
διάδρομοι|ð i  ˈa ð r o m ˌi
διάθεση|ð i  ˈa θ e s ˌi
διάταξε|ð i  ˈa t a k s ˌe
διάφανες|ð i  ˈa f a n ˌe s
διάφανο|ð i  ˈa f a n ˌo
διάφορα|ð i  ˈa f o r ˌa
διέκοψαν|ð i  ˈe k o p s ˌa n
διέκοψε|ð i  ˈe k o p s ˌe
διέκρινε|ð i  ˈe k r i n ˌe
διέσχιζαν|ð i  ˈe s ç i z ˌa n
διέταξε|ð i  ˈe t a k s ˌe
διαβάζει|ð ˌi  a v ˈa z i
διαβάζεις|ð ˌi  a v ˈa z i s
διαβάζουν|ð ˌi  a v ˈa z u n
διαβάζουνταν|ð ˌi  a v ˈa z u d ˌa n
διαβάσει|ð ˌi  a v ˈa s i
διαβάσουν|ð ˌi  a v ˈa s u n
διαβάσω|ð ˌi  a v ˈa s o
διαβάτη|ð ˌi  a v ˈa t i
διαβαίνει|ð ˌi  a v ˈe n i
διαβόλου|ð ˌi  a v ˈo l u
διαδρόμου|ð ˌi  a ð r ˈo m u
διαδρόμους|ð ˌi  a ð r ˈo m u s
διακατεχόμενη|ð ˌi  a k ˌa t e x ˈo m e n ˌi
διακονιάρη|ð ˌi  a k o ɲ ˈa r i
διακρίνουν|ð ˌi  a k r ˈi n u n
διακρίνουνταν|ð ˌi  a k r ˈi n u d ˌa n
διακριτικά|ð ˌi  a k r ˌi t i k ˈa
διακόβοντας|ð ˌi  a k ˈo v o d ˌa s
διαλέγοντας|ð ˌi  a l ˈe ɣ o d ˌa s
διαλέξει|ð ˌi  a l ˈe k s i
διαλεγμένους|ð ˌi  a l e ɣ m ˈe n u s
διαλεχτήν|ð ˌi  a l e x t ˈi n
διαλεχτοί|ð ˌi  a l e x t ˈi
διαλεχτούς|ð ˌi  a l e x t ˈu s
διαμάντια|ð ˌi  a m ˈa d i  ˌa
διαμαντένια|ð ˌi  a m a d ˈe ɲ a
διαμαντικά|ð ˌi  a m ˌa d i k ˈa
διαμαντοστόλιστο|ð ˌi  a m ˌa d o s t ˈo l i s t ˌo
διαμαρτυρήθηκε|ð ˌi  a m ˌa r t i r ˈi θ i c ˌe
διαπίστωσε|ð ˌi  a p ˈi s t o s ˌe
διαπεραστικός|ð ˌi  a p ˌe r a s t i k ˈo s
διαπιστώθηκε|ð ˌi  a p i s t ˈo θ i c ˌe
διασκέδαση|ð ˌi  a s c ˈe ð a s ˌi
διασκεδάσει|ð ˌi  a s c e ð ˈa s i
διασκεδάσεις|ð ˌi  a s c e ð ˈa s i s
διασκεδαστικά|ð ˌi  a s c ˌe ð a s t i k ˈa
διασκεδαστικό|ð ˌi  a s c ˌe ð a s t i k ˈo
διατάζει|ð ˌi  a t ˈa z i
διατάζω|ð ˌi  a t ˈa z o
διατάξεις|ð ˌi  a t ˈa k s i s
διατήρηση|ð ˌi  a t ˈi r i s ˌi
διαταγές|ð ˌi  a t a j ˈe s
διαταγή|ð ˌi  a t a j ˈi
διαφεντευθούν|ð ˌi  a f ˌe d e f θ ˈu n
διαχείρισης|ð ˌi  a ç ˈi r i s ˌi s
διδάσκω|ð i ð ˈa s k o
διευθύνεις|ð ˌi  e f θ ˈi n i s
διευθύνθηκε|ð ˌi  e f θ ˈi n θ i c ˌe
διεύθυνα|ð i  ˈe f θ i n ˌa
διεύθυνε|ð i  ˈe f θ i n ˌe
διεύθυνση|ð i  ˈe f θ i n s ˌi
διηγήθηκαν|ð ˌi  i j ˈi θ i k ˌa n
διηγήθηκε|ð ˌi  i j ˈi θ i c ˌe
διηγούνταν|ð ˌi  i ɣ ˈu d a n
δικά|ð i k ˈa
δικάσει|ð i k ˈa s i
δική|ð i c ˈi
δικαιολογήθηκε|ð ˌi c e ˌo l o j ˈi θ i c ˌe
δικαιοσυνη|ð ˌi c e o s ˈi n i
δικαιοσύνη|ð ˌi c e o s ˈi n i
δικαστές|ð ˌi k a s t ˈe s
δικαστή|ð ˌi k a s t ˈi
δικαστήρια|ð ˌi k a s t ˈi r i  ˌa
δικαστήριο|ð ˌi k a s t ˈi r i  ˌo
δικαστής|ð ˌi k a s t ˈi s
δικούς|ð i k ˈu s
δικό|ð i k ˈo
δικός|ð i k ˈo s
διοίκηση|ð i  ˈi c i s ˌi
διοικήσεις|ð ˌi  i c ˈi s i s
διορίσω|ð ˌi  o r ˈi s o
διοργανωθούμε|ð ˌi  o r ɣ ˌa n o θ ˈu m e
διορθώνοντας|ð ˌi  o r θ ˈo n o d ˌa s
διπλοχέρης|ð ˌi p l o ç ˈe r i s
διπλωμένα|ð ˌi p l o m ˈe n a
διπλωμένο|ð ˌi p l o m ˈe n o
διπλωμένος|ð ˌi p l o m ˈe n o s
διπλό|ð i p l ˈo
δισταγμό|ð ˌi s t a ɣ m ˈo
διστακτικά|ð ˌi s t a k t i k ˈa
διόρθωσα|ð i  ˈo r θ o s ˌa
διόρθωσε|ð i  ˈo r θ o s ˌe
διώξει|ð i  ˈo k s i
διώξομε|ð i  ˈo k s o m ˌe
διώξουμε|ð i  ˈo k s u m ˌe
διώξουν|ð i  ˈo k s u n
διώχνει|ð i  ˈo x n i
δοκίμασε|ð o c ˈi m a s ˌe
δοκιμάσει|ð ˌo c i m ˈa s i
δοκιμάσεις|ð ˌo c i m ˈa s i s
δοκιμάσω|ð ˌo c i m ˈa s o
δουλέψει|ð u l ˈe p s i
δουλέψεις|ð u l ˈe p s i s
δουλέψομε|ð u l ˈe p s o m ˌe
δουλέψουμε|ð u l ˈe p s u m ˌe
δουλέψουν|ð u l ˈe p s u n
δουλέψω|ð u l ˈe p s o
δουλεία|ð u l ˈi  a
δουλειά|ð u ʎ ˈa
δουλειές|ð u ʎ ˈe s
δουλεια|ð ˈu ʎ a
δουλευτάδες|ð ˌu l e f t ˈa ð e s
δουλεύαμε|ð u l ˈe v a m ˌe
δουλεύει|ð u l ˈe v i
δουλεύεις|ð u l ˈe v i s
δουλεύετε|ð u l ˈe v e t ˌe
δουλεύοντας|ð u l ˈe v o d ˌa s
δουλεύουν|ð u l ˈe v u n
δουν|ð ˈu n
δούλευα|ð ˈu l e v ˌa
δούλευαν|ð ˈu l e v ˌa n
δούλευε|ð ˈu l e v ˌe
δούλεψαν|ð ˈu l e p s ˌa n
δούλεψε|ð ˈu l e p s ˌe
δούλο|ð ˈu l o
δούμε|ð ˈu m e
δράνα|ð r ˈa n a
δρεπάνι|ð r e p ˈa n i
δρεπάνια|ð r e p ˈa ɲ a
δροσίζουνταν|ð r o s ˈi z u d ˌa n
δροσερά|ð r ˌo s e r ˈa
δροσερό|ð r ˌo s e r ˈo
δροσιά|ð r o s j ˈa
δρόμο|ð r ˈo m o
δρόμοι|ð r ˈo m i
δρόμος|ð r ˈo m o s
δρόμου|ð r ˈo m u
δρόμους|ð r ˈo m u s
δυνατά|ð ˌi n a t ˈa
δυνατό|ð ˌi n a t ˈo
δυνατός|ð ˌi n a t ˈo s
δυνατότερες|ð ˌi n a t ˈo t e r ˌe s
δυνατότερο|ð ˌi n a t ˈo t e r ˌo
δυο|ð ˈi  o
δυσάρεστα|ð i s ˈa r e s t ˌa
δυσάρεστη|ð i s ˈa r e s t ˌi
δυσαρέσκεια|ð ˌi s a r ˈe s c a
δυσαρεστημένος|ð ˌi s a r ˌe s t i m ˈe n o s
δυσκολίες|ð ˌi s k o l ˈi  e s
δυσκολευόταν|ð ˌi s k o l e v ˈo t a n
δυστυχία|ð ˌi s t i ç ˈi  a
δυστυχίας|ð ˌi s t i ç ˈi  a s
δυστυχίες|ð ˌi s t i ç ˈi  e s
δυστυχισμένο|ð ˌi s t i ç i s m ˈe n o
δυστυχισμένον|ð ˌi s t i ç i s m ˈe n o n
δυστυχισμένος|ð ˌi s t i ç i s m ˈe n o s
δυστυχόπουλο|ð ˌi s t i x ˈo p u l ˌo
δυστυχώς|ð ˌi s t i x ˈo s
δω|ð ˈo
δωμάτιά|ð o m ˈa t i  ˈa
δωμάτια|ð o m ˈa t i  ˌa
δωμάτιο|ð o m ˈa t i  ˌo
δωμάτιό|ð o m ˈa t i  ˈo
δωματίων|ð ˌo m a t ˈi  o n
δωρο|ð ˈo r o
δωρος|ð ˈo r o s
δωσ'|ð ˈo s
δόλιον|ð ˈo ʎ o n
δόξα|ð ˈo k s a
δύση|ð ˈi s i
δύσκολο|ð ˈi s k o l ˌo
δύστυχη|ð ˈi s t i ç ˌi
δώμα|ð ˈo m a
δώρο|ð ˈo r o
δώσ'|ð ˈo s
δώσε|ð ˈo s e
δώσεις|ð ˈo s i s
δώσετε|ð ˈo s e t ˌe
δώσομε|ð ˈo s o m ˌe
δώστε|ð ˈo s t e
ε|ˈe p s i l ˌo n
ε'|ˈe p s i l ˌo n
είδα|ˈi ð a
είδαμε|ˈi ð a m ˌe
είδαν|ˈi ð a n
είδε|ˈi ð e
είδες|ˈi ð e s
είδηση|ˈi ð i s ˌi
είδος|ˈi ð o s
είκοσι|ˈi k o s ˌi
είμαι|ˈi m e
είπα|ˈi p a
είπαμε|ˈi p a m ˌe
είπαν|ˈi p a n
είπε|ˈi p e
είπες|ˈi p e s
είσαι|ˈi s e
είσθε|ˈi s θ e
είσοδο|ˈi s o ð ˌo
είστε|ˈi s t e
είτε|ˈi t e
είχες|ˈi ç e s
εαυτό|ˌe a f t ˈo
εβαλε|e v ˈa l e
εβδομάδα|ˌe v ð o m ˈa ð a
εβδομάδες|ˌe v ð o m ˈa ð e s
εγέρασε|e j ˈe r a s ˌe
εγκρίνεις|e ŋ ɡ r ˈi n i s
εγύρισε|e j ˈi r i s ˌe
εγύρισες|e j ˈi r i s ˌe s
εδόθη|e ð ˈo θ i
εδώ|e ð ˈo
ειδήσεις|i ð ˈi s i s
ειδεμή|ˌi ð e m ˈi
ειδοποιήσεις|ˌi ð o p i  ˈi s i s
ειρηνούλα|ˌi r i n ˈu l a
ειρηνούλας|ˌi r i n ˈu l a s
ειρωνεία|ˌi r o n ˈi  a
ειρωνικά|ˌi r o n i k ˈa
εισβάλλει|i s v ˈa l i
εισβάλουν|i s v ˈa l u n
εκάναμε|e k ˈa n a m ˌe
εκατόνταρχο|ˌe k a t ˈo d a r x ˌo
εκατόνταρχος|ˌe k a t ˈo d a r x ˌo s
εκδικηθεί|ˌe k ð i c i θ ˈi
εκεί|e c ˈi
εκείνα|e c ˈi n a
εκείνο|e c ˈi n o
εκείνον|e c ˈi n o n
εκείνος|e c ˈi n o s
εκείνους|e c ˈi n u s
εκπατρίζονται|ˌe k p a t r ˈi z o d ˌe
εκπατριστείς|ˌe k p a t r i s t ˈi s
εκστρατεύσει|ˌe k s t r a t ˈe f s i
εκτελέσει|ˌe k t e l ˈe s i
εκτελέσω|ˌe k t e l ˈe s o
εκτός|e k t ˈo s
ελ|ˈe l
ελάφια|e l ˈa f i  ˌa
ελαιώνες|ˌe l e ˈo n e s
ελεεινό|ˌe l e i n ˈo
ελεεινός|ˌe l e i n ˈo s
ελευθερία|ˌe l e f θ e r ˈi  a
ελευθερώσεις|ˌe l e f θ e r ˈo s i s
ελευθερώσουν|ˌe l e f θ e r ˈo s u n
ελεύθερα|e l ˈe f θ e r ˌa
ελεύθερο|e l ˈe f θ e r ˌo
ελεύθερος|e l ˈe f θ e r ˌo s
ελιές|e ʎ ˈe s
ελπίδα|e l p ˈi ð a
ελπίδες|e l p ˈi ð e s
ελπίζεις|e l p ˈi z i s
ελπίζω|e l p ˈi z o
εμάθαμε|e m ˈa θ a m ˌe
εμάς|e m ˈa s
εμένα|e m ˈe n a
εμήνυσα|e m ˈi n i s ˌa
εμβαδού|ˌe m v a ð ˈu
εμείς|e m ˈi s
εμεις|ˈe m i s
εμπιστευθεί|ˌe b i s t e f θ ˈi
εμπιστευθείς|ˌe b i s t e f θ ˈi s
εμπιστεύθηκες|ˌe b i s t ˈe f θ i c ˌe s
εμποδίσει|ˌe b o ð ˈi s i
εμποδίσεις|ˌe b o ð ˈi s i s
εμποδίσουμε|ˌe b o ð ˈi s u m ˌe
εμπρός|e b r ˈo s
εμπόδιζα|e b ˈo ð i z ˌa
εναντιώθηκε|ˌe n a d i  ˈo θ i c ˌe
ενεργήσομε|ˌe n e r j ˈi s o m ˌe
ενθουσίασε|ˌe n θ u s ˈi  a s ˌe
ενθουσιάστηκε|ˌe n θ u s j ˈa s t i c ˌe
ενθουσιασμένα|ˌe n θ u s j a s m ˈe n a
ενθουσιασμένο|ˌe n θ u s j a s m ˈe n o
ενθουσιασμό|ˌe n θ u s j a s m ˈo
ενθουσιασμός|ˌe n θ u s j a s m ˈo s
εννοήσει|ˌe n o ˈi s i
εννοήσεις|ˌe n o ˈi s i s
εννοείς|ˌe n o ˈi s
εννοούσε|ˌe n o ˈu s e
εννόησε|e n ˈoɪ s e
ενοχλείτε|ˌe n o x l ˈi t e
ενοχλούμε|ˌe n o x l ˈu m e
εντατική|ˌe d a t i c ˈi
ενωμένες|ˌe n o m ˈe n e s
ενωμένοι|ˌe n o m ˈe n i
ενός|e n ˈo s
ενόσω|e n ˈo s o
ενώ|e n ˈo
εξάδελφο|e k s ˈa ð e l f ˌo
εξάδελφος|e k s ˈa ð e l f ˌo s
εξάψει|e k s ˈa p s i
εξέταζε|e k s ˈe t a z ˌe
εξέτασε|e k s ˈe t a s ˌe
εξήγησε|e k s ˈi j i s ˌe
εξήγηση|e k s ˈi j i s ˌi
εξαγριωμένος|ˌe k s a ɣ r ˌi  o m ˈe n o s
εξαδέλφου|ˌe k s a ð ˈe l f u
εξαδελφος|ˌe k s a ð ˈe l f o s
εξακολουθείς|ˌe k s a k ˌo l u θ ˈi s
εξακολουθούσαν|ˌe k s a k ˌo l u θ ˈu s a n
εξακολουθούσε|ˌe k s a k ˌo l u θ ˈu s e
εξακολουθώντας|ˌe k s a k ˌo l u θ ˈo d a s
εξακολούθησαν|ˌe k s a k o l ˈu θ i s ˌa n
εξακολούθησε|ˌe k s a k o l ˈu θ i s ˌe
εξακοσίων|ˌe k s a k o s ˈi  o n
εξαφανίσου|ˌe k s a f a n ˈi s u
εξετάζει|ˌe k s e t ˈa z i
εξετάσεις|ˌe k s e t ˈa s i s
εξεταστικών|ˌe k s e t ˌa s t i k ˈo n
εξηγήσει|ˌe k s i j ˈi s i
εξηγήσεις|ˌe k s i j ˈi s i s
εξηγεί|ˌe k s i j ˈi
εξηγείς|ˌe k s i j ˈi s
εξοικειωθούν|ˌe k s i c o θ ˈu n
εξοργισμένο|ˌe k s o r j i s m ˈe n o
εξοχής|ˌe k s o ç ˈi s
εξοχότατε|ˌe k s o x ˈo t a t ˌe
εξοχότητά|ˌe k s o x ˈo t i t ˈa
εξοχώτατε|ˌe k s o x ˈo t a t ˌe
εξοχώτατος|ˌe k s o x ˈo t a t ˌo s
εξοχώτατου|ˌe k s o x ˈo t a t ˌu
εξωτερικά|ˌe k s o t ˌe r i k ˈa
εξόδου|e k s ˈo ð u
εξώπορτα|e k s ˈo p o r t ˌa
εξώστης|e k s ˈo s t i s
εξώφυλλο|e k s ˈo f i l ˌo
εορτή|ˌe o r t ˈi
επάνω|e p ˈa n o
επέλεγες|e p ˈe l e j ˌe s
επέμεινε|e p ˈe m i n ˌe
επέστρεφε|e p ˈe s t r e f ˌe
επέστρεψε|e p ˈe s t r e p s ˌe
επίδραση|e p ˈi ð r a s ˌi
επίσης|e p ˈi s i s
επίτηδες|e p ˈi t i ð ˌe s
επίτροπε|e p ˈi t r o p ˌe
επανάσταση|ˌe p a n ˈa s t a s ˌi
επανέλαβαν|ˌe p a n ˈe l a v ˌa n
επανέλαβε|ˌe p a n ˈe l a v ˌe
επαναλάβεις|ˌe p a n a l ˈa v i s
επανωφόρι|ˌe p a n o f ˈo r i
επειδή|ˌe p i ð ˈi
επιβάλλει|ˌe p i v ˈa l i
επιβλήθηκε|ˌe p i v l ˈi θ i c ˌe
επιβλαβή|ˌe p i v l a v ˈi
επιγραφή|ˌe p i ɣ r a f ˈi
επιδίωξη|ˌe p i ð ˈi  o k s ˌi
επιδιορθώσει|ˌe p i ð ˌi  o r θ ˈo s i
επισκεφθείτε|ˌe p i s c e f θ ˈi t e
επιστήμονες|ˌe p i s t ˈi m o n ˌe s
επιστρέφοντας|ˌe p i s t r ˈe f o d ˌa s
επιστρέφουν|ˌe p i s t r ˈe f u n
επιστρέψει|ˌe p i s t r ˈe p s i
επιστρέψομε|ˌe p i s t r ˈe p s o m ˌe
επιτέλους|ˌe p i t ˈe l u s
επιτήδειος|ˌe p i t ˈi ð ç o s
επιτήδειους|ˌe p i t ˈi ð ç u s
επιτήρηση|ˌe p i t ˈi r i s ˌi
επιτακτικά|ˌe p i t ˌa k t i k ˈa
επιτακτικό|ˌe p i t ˌa k t i k ˈo
επιτύχει|ˌe p i t ˈi ç i
επιτύχω|ˌe p i t ˈi x o
επιφάνεια|ˌe p i f ˈa ɲ a
επιφυλακτικά|ˌe p i f ˌi l a k t i k ˈa
επλήρωνε|e p l ˈi r o n ˌe
εποχής|ˌe p o ç ˈi s
επρόδωσες|e p r ˈo ð o s ˌe s
επόμενο|e p ˈo m e n ˌo
επόμενου|e p ˈo m e n ˌu
ερ|ˈe r
εργάτες|e r ɣ ˈa t e s
εργάτριες|e r ɣ ˈa t r i  ˌe s
εργαλεία|ˌe r ɣ a l ˈi  a
εργαλείων|ˌe r ɣ a l ˈi  o n
εργαστήρι|ˌe r ɣ a s t ˈi r i
εργαστείς|ˌe r ɣ a s t ˈi s
εργαστώ|ˌe r ɣ a s t ˈo
εργοστάσιο|ˌe r ɣ o s t ˈa s j o
ερείπια|e r ˈi p ç a
ερείπιο|e r ˈi p ç o
ερειπωμένα|ˌe r i p o m ˈe n a
ερειπωμένες|ˌe r i p o m ˈe n e s
ερειπωμένο|ˌe r i p o m ˈe n o
ερειπωμένους|ˌe r i p o m ˈe n u s
ερημιά|ˌe r i m i  ˈa
ερημώθηκε|ˌe r i m ˈo θ i c ˌe
ερχόμενες|e r x ˈo m e n ˌe s
ερχόμουν|e r x ˈo m u n
ερχόταν|e r x ˈo t a n
εσένα|e s ˈe n a
εσήμανε|e s ˈi m a n ˌe
εσείς|e s ˈi s
εσερβίρισε|ˌe s e r v ˈi r i s ˌe
εσκέπασε|e s c ˈe p a s ˌe
εσπρέσο|e s p r ˈe s o
εσταμάτησε|ˌe s t a m ˈa t i s ˌe
εσωτερικό|ˌe s o t ˌe r i k ˈo
εσύ|e s ˈi
εταιρεία|ˌe t e r ˈi  a
ετοίμαζε|e t ˈi m a z ˌe
ετοίμασαν|e t ˈi m a s ˌa n
ετοιμάζεται|ˌe t i m ˈa z e t ˌe
ετοιμάζονταν|ˌe t i m ˈa z o d ˌa n
ετοιμάζουνταν|ˌe t i m ˈa z u d ˌa n
ετοιμάσει|ˌe t i m ˈa s i
ετούτη|e t ˈu t i
ετούτο|e t ˈu t o
ευβοίας|e v ˈi  a s
ευγένεια|e v j ˈe ɲ a
ευγενικός|ˌe v j e n i k ˈo s
ευθύνη|e f θ ˈi n i
ευθύς|e f θ ˈi s
ευκολώτερα|ˌe f k o l ˈo t e r ˌa
ευκόλυνες|e f k ˈo l i n ˌe s
ευλογία|ˌe v l o j ˈi  a
ευλογημένος|ˌe v l o j i m ˈe n o s
ευλόγησε|e v l ˈo j i s ˌe
ευτυχία|ˌe f t i ç ˈi  a
ευτυχώς|ˌe f t i x ˈo s
ευχή|e f ç ˈi
ευχαρίστησαν|ˌe f x a r ˈi s t i s ˌa n
ευχαρίστηση|ˌe f x a r ˈi s t i s ˌi
ευχαριστηθεί|ˌe f x a r ˌi s t i θ ˈi
ευχαριστημένες|ˌe f x a r ˌi s t i m ˈe n e s
ευχαριστημένος|ˌe f x a r ˌi s t i m ˈe n o s
ευωδιά|ˌe v o ð i  ˈa
εφθάναμε|e f θ ˈa n a m ˌe
εφθάσαμε|e f θ ˈa s a m ˌe
εφιάλτες|ˌe f i  ˈa l t e s
εφοβήθηκα|ˌe f o v ˈi θ i k ˌa
εχθρική|ˌe x θ r i c ˈi
εχθρικό|ˌe x θ r i k ˈo
εχθροί|e x θ r ˈi
εχθρού|e x θ r ˈu
εχθρούς|e x θ r ˈu s
εχθρό|e x θ r ˈo
εχθρός|e x θ r ˈo s
εχθρών|e x θ r ˈo n
εύκολα|ˈe f k o l ˌa
εύκολο|ˈe f k o l ˌo
ζ'|z ˈi t a
ζάλισες|z ˈa l i s ˌe s
ζάρια|z ˈa r i  ˌa
ζέστανε|z ˈe s t a n ˌe
ζήλιω|z ˈi ʎ o
ζήλιως|z ˈi ʎ o s
ζήλο|z ˈi l o
ζήσε|z ˈi s e
ζήσει|z ˈi s i
ζήσεις|z ˈi s i s
ζήσουν|z ˈi s u n
ζήσω|z ˈi s o
ζήτησε|z ˈi t i s ˌe
ζήτω|z ˈi t o
ζαλίζεις|z a l ˈi z i s
ζαλίζεστε|z a l ˈi z e s t ˌe
ζαλισμένα|z ˌa l i s m ˈe n a
ζαλισμένο|z ˌa l i s m ˈe n o
ζαλισμένος|z ˌa l i s m ˈe n o s
ζαρουκλιασμένο|z ˌa r u k ʎ a s m ˈe n o
ζαρωμένα|z ˌa r o m ˈe n a
ζαρώσει|z a r ˈo s i
ζεβζέκης|z e v z ˈe c i s
ζει|z ˈi
ζελατίνα|z ˌe l a t ˈi n a
ζεστάνεις|z e s t ˈa n i s
ζεστή|z e s t ˈi
ζεσταίνουν|z e s t ˈe n u n
ζεσταθούμε|z ˌe s t a θ ˈu m e
ζεστοί|z e s t ˈi
ζεστός|z e s t ˈo s
ζευγαρώσει|z ˌe v ɣ a r ˈo s i
ζεύθηκαν|z ˈe f θ i k ˌa n
ζηλευτά|z ˌi l e f t ˈa
ζημιώσει|z ˌi m i  ˈo s i
ζητά|z i t ˈa
ζητάς|z i t ˈa s
ζητάτε|z i t ˈa t e
ζητήσει|z i t ˈi s i
ζητήσεις|z i t ˈi s i s
ζητήσουν|z i t ˈi s u n
ζητήσω|z i t ˈi s o
ζητιάνο|z ˌi t i  ˈa n o
ζητιάνοι|z ˌi t i  ˈa n i
ζητιάνος|z ˌi t i  ˈa n o s
ζητιάνου|z ˌi t i  ˈa n u
ζητιάνους|z ˌi t i  ˈa n u s
ζητιανέψω|z ˌi t i  a n ˈe p s o
ζητιανεύεις|z ˌi t i  a n ˈe v i s
ζητιανόπαιδα|z ˌi t i  a n ˈo p e ð ˌa
ζητούσε|z i t ˈu s e
ζητώ|z i t ˈo
ζουν|z ˈu n
ζούλευε|z ˈu l e v ˌe
ζούμε|z ˈu m e
ζούσαν|z ˈu s a n
ζούσε|z ˈu s e
ζυγώσει|z i ɣ ˈo s i
ζυμώνουν|z i m ˈo n u n
ζυμώνω|z i m ˈo n o
ζω|z ˈo
ζωές|z o ˈe s
ζωής|z o ˈi s
ζωηρά|z ˌo i r ˈa
ζωνη|z ˈo n i
ζωντανή|z ˌo d a n ˈi
ζωντανό|z ˌo d a n ˈo
ζωύφιο|z o ˈi f i  ˌo
ζύγωσε|z ˈi ɣ o s ˌe
ζύμωναν|z ˈi m o n ˌa n
ζώα|z ˈo a
ζώνη|z ˈo n i
ζώνης|z ˈo n i s
ζώντας|z ˈo d a s
η|ˈi t a
ηλίου|i l ˈi  u
ηλεκτρίστηκε|ˌi l e k t r ˈi s t i c ˌe
ηλικιωμένος|ˌi l i c o m ˈe n o s
ημέρα|i m ˈe r a
ημέρας|i m ˈe r a s
ημερεμένος|ˌi m e r e m ˈe n o s
ηρωικά|ˌi r o i k ˈa
ηρωική|ˌi r o i c ˈi
ηρωισμός|ˌi r o i s m ˈo s
ησυχάσω|ˌi s i x ˈa s o
ησυχία|ˌi s i ç ˈi  a
ησυχότατο|ˌi s i x ˈo t a t ˌo
ησύχαζε|i s ˈi x a z ˌe
ησύχασε|i s ˈi x a s ˌe
θ'|θ ˈi t a
θάλαμο|θ ˈa l a m ˌo
θάμπωμα|θ ˈa b o m ˌa
θάνατο|θ ˈa n a t ˌo
θάνο|θ ˈa n o
θάνος|θ ˈa n o s
θάρρος|θ ˈa r o s
θέαμα|θ ˈe a m ˌa
θέλαμε|θ ˈe l a m ˌe
θέλει|θ ˈe l i
θέλεις|θ ˈe l i s
θέλετε|θ ˈe l e t ˌe
θέλησα|θ ˈe l i s ˌa
θέλησαν|θ ˈe l i s ˌa n
θέλησε|θ ˈe l i s ˌe
θέλησες|θ ˈe l i s ˌe s
θέληση|θ ˈe l i s ˌi
θέλομε|θ ˈe l o m ˌe
θέλοντας|θ ˈe l o d ˌa s
θέλουμε|θ ˈe l u m ˌe
θέλουν|θ ˈe l u n
θέριζαν|θ ˈe r i z ˌa n
θέριζε|θ ˈe r i z ˌe
θέρισαν|θ ˈe r i s ˌa n
θέση|θ ˈe s i
θέτε|θ ˈe t e
θέτει|θ ˈe t i
θήκη|θ ˈi c i
θα|θ ˈa
θαμπώνουν|θ a b ˈo n u n
θανούσα|θ a n ˈu s a
θαρρείς|θ a r ˈi s
θαυμάζοντας|θ a v m ˈa z o d ˌa s
θαυμάσια|θ a v m ˈa s j a
θαυμασμό|θ ˌa v m a s m ˈo
θαύμασε|θ ˈa v m a s ˌe
θείο|θ ˈi  o
θείος|θ ˈi  o s
θείου|θ ˈi  u
θειάφι|θ ç ˈa f i
θειας|θ ç ˈa s
θειαφώσει|θ ç a f ˈo s i
θειος|θ ç ˈo s
θειου|θ ç ˈu
θελήσει|θ e l ˈi s i
θελήσεις|θ e l ˈi s i s
θεού|θ e ˈu
θες|θ ˈe s
θεση|θ ˈe s i
θεωρείς|θ ˌe o r ˈi s
θεό|θ e ˈo
θεόρατα|θ e ˈo r a t ˌa
θεόρατο|θ e ˈo r a t ˌo
θεόρατους|θ e ˈo r a t ˌu s
θεός|θ e ˈo s
θηρία|θ i r ˈi  a
θησαυρού|θ ˌi s a v r ˈu
θησαυρούς|θ ˌi s a v r ˈu s
θησαυρό|θ ˌi s a v r ˈo
θησαυρός|θ ˌi s a v r ˈo s
θλίβουνταν|θ l ˈi v u d ˌa n
θλιμμένος|θ l i m ˈe n o s
θρέψει|θ r ˈe p s i
θρέψω|θ r ˈe p s o
θρασύμαχε·|θ r a s ˈi m a ç ˌe
θριαμβευτικά|θ r ˌi  a m v ˌe f t i k ˈa
θριαμβευτικές|θ r ˌi  a m v ˌe f t i c ˈe s
θριαμβευτικό|θ r ˌi  a m v ˌe f t i k ˈo
θρόνο|θ r ˈo n o
θυμάρι|θ i m ˈa r i
θυμάσαι|θ i m ˈa s e
θυμάστε|θ i m ˈa s t e
θυμήθηκα|θ i m ˈi θ i k ˌa
θυμήθηκε|θ i m ˈi θ i c ˌe
θυμήσου|θ i m ˈi s u
θυμίζεις|θ i m ˈi z i s
θυμίζουν|θ i m ˈi z u n
θυμηθείς|θ ˌi m i θ ˈi s
θυμούνταν|θ i m ˈu d a n
θυμωμένες|θ ˌi m o m ˈe n e s
θυμωμένος|θ ˌi m o m ˈe n o s
θυμό|θ i m ˈo
θυμός|θ i m ˈo s
θυμόταν|θ i m ˈo t a n
θυμώνει|θ i m ˈo n i
θυμώσω|θ i m ˈo s o
θυσία|θ i s ˈi  a
θυσίες|θ i s ˈi  e s
θόρυβο|θ ˈo r i v ˌo
θύμισέ|θ ˈi m i s ˈe
θύμισε|θ ˈi m i s ˌe
θύμωνε|θ ˈi m o n ˌe
θύμωσε|θ ˈi m o s ˌe
θώρακες|θ ˈo r a c ˌe s
ι'|i  ˈo t a
ια'|ˈi  a
ιατρικό|ˌi  a t r i k ˈo
ιγ'|ˈi ɣ
ιδ'|ˈi ð
ιδέα|i ð ˈe a
ιδρωμένο|ˌi ð r o m ˈe n o
ιδρωμένος|ˌi ð r o m ˈe n o s
ιδρώτα|i ð r ˈo t a
ιδρώτας|i ð r ˈo t a s
ιερά|ˌi  e r ˈa
ιερό|ˌi  e r ˈo
ιζ'|ˈi z
ιη'|ˈi  i
ιθ'|ˈi θ
ικανοποιημένος|ˌi k a n ˌo p i  i m ˈe n o s
ινστιτούτο|ˌi n s t i t ˈu t o
ιππικό|ˌi p i k ˈo
ιστ'|ˈi s t
ιστιαίας|ˌi s t i  ˈe a s
ιστορία|ˌi s t o r ˈi  a
ιστορίες|ˌi s t o r ˈi  e s
ισχύει|i s ç ˈi  i
ισχύς|i s ç ˈi s
ισως|ˈi s o s
κ'|k ˈa p a
κάθε|k ˈa θ e
κάθεσαι|k ˈa θ e s ˌe
κάθεστε|k ˈa θ e s t ˌe
κάθεται|k ˈa θ e t ˌe
κάθη|k ˈa θ i
κάθησαν|k ˈa θ i s ˌa n
κάθησε|k ˈa θ i s ˌe
κάθισαν|k ˈa θ i s ˌa n
κάθισε|k ˈa θ i s ˌe
κάθισες|k ˈa θ i s ˌe s
κάθισμα|k ˈa θ i s m ˌa
κάθομαι|k ˈa θ o m ˌe
κάθονται|k ˈa θ o d ˌe
κάθουμουν|k ˈa θ u m ˌu n
κάθουνταν|k ˈa θ u d ˌa n
κάκου|k ˈa k u
κάλτσα|k ˈa l ts a
κάμαρα|k ˈa m a r ˌa
κάμαρας|k ˈa m a r ˌa s
κάμαρες|k ˈa m a r ˌe s
κάμπο|k ˈa b o
κάμπος|k ˈa b o s
κάμποσα|k ˈa b o s ˌa
κάμποσες|k ˈa b o s ˌe s
κάμποση|k ˈa b o s ˌi
κάμποσην|k ˈa b o s ˌi n
κάμποσο|k ˈa b o s ˌo
κάμπου|k ˈa b u
κάμπους|k ˈa b u s
κάμω|k ˈa m o
κάναμε|k ˈa n a m ˌe
κάνατε|k ˈa n a t ˌe
κάνε|k ˈa n e
κάνει|k ˈa n i
κάνεις|k ˈa n i s
κάνετε|k ˈa n e t ˌe
κάνομε|k ˈa n o m ˌe
κάνοντας|k ˈa n o d ˌa s
κάνουμε|k ˈa n u m ˌe
κάνουν|k ˈa n u n
κάνω|k ˈa n o
κάπνιζε|k ˈa p n i z ˌe
κάπνισε|k ˈa p n i s ˌe
κάποια|k ˈa p i  ˌa
κάποιο|k ˈa p i  ˌo
κάποιον|k ˈa p i  ˌo n
κάποιος|k ˈa p i  ˌo s
κάπου|k ˈa p u
κάπως|k ˈa p o s
κάρδαμα|k ˈa r ð a m ˌa
κάρτα|k ˈa r t a
κάρτες|k ˈa r t e s
κάστρα|k ˈa s t r a
κάστρου|k ˈa s t r u
κάτασπρα|k ˈa t a s p r ˌa
κάτασπρο|k ˈa t a s p r ˌo
κάτι|k ˈa t i
κάτια|k ˈa t i  ˌa
κάτοικοι|k ˈa t i c ˌi
κάτω|k ˈa t o
κάψα|k ˈa p s a
κέντημα|c ˈe d i m ˌa
κέρδιζε|c ˈe r ð i z ˌe
κέρδος|c ˈe r ð o s
κίνδυνο|c ˈi n ð i n ˌo
κίνδυνος|c ˈi n ð i n ˌo s
κίνησε|c ˈi n i s ˌe
κίνηση|c ˈi n i s ˌi
καίει|c ˈe i
καβαλάρη|k ˌa v a l ˈa r i
καβαλάρηδες|k ˌa v a l ˈa r i ð ˌe s
καβαλάρης|k ˌa v a l ˈa r i s
καβαλίκεψε|k ˌa v a l ˈi c e p s ˌe
καβαλαρέοι|k ˌa v a l a r ˈe i
καβγά|k a v ɣ ˈa
καβγάδες|k a v ɣ ˈa ð e s
καβγάς|k a v ɣ ˈa s
καζάνι|k a z ˈa n i
καζάνια|k a z ˈa ɲ a
καημένο|k aɪ m ˈe n o
καημένος|k aɪ m ˈe n o s
καημό|k aɪ m ˈo
καθένα|k a θ ˈe n a
καθένας|k a θ ˈe n a s
καθήκον|k a θ ˈi k o n
καθήσαμε|k a θ ˈi s a m ˌe
καθήσατε|k a θ ˈi s a t ˌe
καθήσομε|k a θ ˈi s o m ˌe
καθήσουν|k a θ ˈi s u n
καθήστε|k a θ ˈi s t e
καθίσομε|k a θ ˈi s o m ˌe
καθίστε|k a θ ˈi s t e
καθαρίσω|k ˌa θ a r ˈi s o
καθεμιά|k ˌa θ e m i  ˈa
καθενός|k ˌa θ e n ˈo s
καθησύχαζε|k ˌa θ i s ˈi x a z ˌe
καθησύχασε|k ˌa θ i s ˈi x a s ˌe
καθισμένο|k ˌa θ i s m ˈe n o
καθισμένος|k ˌa θ i s m ˈe n o s
καθισμένους|k ˌa θ i s m ˈe n u s
καθιστός|k ˌa θ i s t ˈo s
καθρέφτη|k a θ r ˈe f t i
καθυστέρηση|k ˌa θ i s t ˈe r i s ˌi
καθυστερημένες|k ˌa θ i s t ˌe r i m ˈe n e s
καθόλου|k a θ ˈo l u
καθόμαστε|k a θ ˈo m a s t ˌe
καθώς|k a θ ˈo s
και|k ˈe
καιμ'|c ˈe m
καινουριες|c ˌe n u r ˈi  e s
καινούρια|c e n ˈu r i  ˌa
καινούριες|c e n ˈu r i  ˌe s
καινούριο|c e n ˈu r i  ˌo
καινούριος|c e n ˈu r i  ˌo s
καινούριους|c e n ˈu r i  ˌu s
καιροί|c e r ˈi
καιρούς|c e r ˈu s
καιρό|c e r ˈo
καιρός|c e r ˈo s
κακά|k a k ˈa
κακές|k a c ˈe s
κακία|k a c ˈi  a
κακιωμένος|k ˌa c o m ˈe n o s
κακιώματα|k a c ˈo m a t ˌa
κακοήθεια|k ˌa k o ˈi θ ç a
κακοί|k a c ˈi
κακοκαρδίζεις|k ˌa k o k a r ð ˈi z i s
κακοκαρδίσει|k ˌa k o k a r ð ˈi s i
κακομοίρα|k ˌa k o m ˈi r a
κακομοίρη|k ˌa k o m ˈi r i
κακομοίρης|k ˌa k o m ˈi r i s
κακομοιρίδη|k ˌa k o m i r ˈi ð i
κακομοιρίδης|k ˌa k o m i r ˈi ð i s
κακορίζικοι|k ˌa k o r ˈi z i c ˌi
κακοριζικιά|k ˌa k o r ˌi z i c ˈa
κακοφαίνεται|k ˌa k o f ˈe n e t ˌe
κακού|k a k ˈu
κακούργους|k a k ˈu r ɣ u s
κακούς|k a k ˈu s
κακό|k a k ˈo
κακόμοιρο|k a k ˈo m i r ˌo
κακός|k a k ˈo s
καλά|k a l ˈa
καλάθι|k a l ˈa θ i
καλάμια|k a l ˈa m i  ˌa
καλές|k a l ˈe s
καλή|k a l ˈi
καλαθάκι|k ˌa l a θ ˈa c i
καλαμιώνες|k ˌa l a m i  ˈo n e s
καλαμπόκια·|k ˌa l a b ˈo c a
καλημερίσει|k ˌa l i m e r ˈi s i
καληνύχτα|k ˌa l i n ˈi x t a
καλλιέργειας|k a ʎ ˈe r j a s
καλλιεργήσει|k ˌa ʎ e r j ˈi s i
καλλιεργήσουν|k ˌa ʎ e r j ˈi s u n
καλλιεργητικών|k ˌa ʎ e r j ˌi t i k ˈo n
καλλιεργούν|k ˌa ʎ e r ɣ ˈu n
καλλιεργούσαμε|k ˌa ʎ e r ɣ ˈu s a m ˌe
καλοζεί|k ˌa l o z ˈi
καλοκαταλάβει|k ˌa l o k ˌa t a l ˈa v i
καλοπέραση|k ˌa l o p ˈe r a s ˌi
καλοπιάσματα|k ˌa l o p ç ˈa s m a t ˌa
καλοστρωμένοι|k ˌa l o s t r o m ˈe n i
καλοστρωμένος|k ˌa l o s t r o m ˈe n o s
καλοσύνη|k ˌa l o s ˈi n i
καλοχτισμένα|k ˌa l o x t i s m ˈe n a
καλοχτισμένες|k ˌa l o x t i s m ˈe n e s
καλούς|k a l ˈu s
καλυβάκι|k ˌa l i v ˈa c i
καλόν|k a l ˈo n
καλός|k a l ˈo s
καλύβα|k a l ˈi v a
καλύβες|k a l ˈi v e s
καλύβια|k a l ˈi v i  ˌa
καλύτερα|k a l ˈi t e r ˌa
καλύτερο|k a l ˈi t e r ˌo
καλύτεροι|k a l ˈi t e r ˌi
καλύτερος|k a l ˈi t e r ˌo s
καλύτερους|k a l ˈi t e r ˌu s
καλώς|k a l ˈo s
καμάρι|k a m ˈa r i
καμία|k a m ˈi  a
καμαράκι|k ˌa m a r ˈa c i
καμαρωτά|k ˌa m a r o t ˈa
καμιά|k ˌa m i  ˈa
καμιάν|k ˌa m i  ˈa n
καμπούρα|k a b ˈu r a
καμπούρη|k a b ˈu r i
καμπούρης|k a b ˈu r i s
καμπόσους|k a b ˈo s u s
καμτσίκι|k a m ts ˈi c i
καμτσικιά|k ˌa m ts i c ˈa
καμώματα|k a m ˈo m a t ˌa
κανένα|k a n ˈe n a
κανέναν|k a n ˈe n a n
κανένας|k a n ˈe n a s
κανείς|k a n ˈi s
κανονίσομε|k ˌa n o n ˈi s o m ˌe
κανονίσω|k ˌa n o n ˈi s o
κανονικό|k ˌa n o n i k ˈo
καπνίζοντας|k a p n ˈi z o d ˌa s
καπουτσίνο|k ˌa p u ts ˈi n o
καράβι|k a r ˈa v i
καράβια|k a r ˈa v i  ˌa
καρέγλα|k a r ˈe ɣ l a
καρέγλας|k a r ˈe ɣ l a s
καρέγλες|k a r ˈe ɣ l e s
καραβιά|k ˌa r a v i  ˈa
καραβιού|k ˌa r a v i  ˈu
καραβιών|k ˌa r a v i  ˈo n
καραγκιοζιλίκια|k ˌa r a ŋ ɡ ˌi  o z i l ˈi c a
καραγκιοζλίκια|k ˌa r a ŋ ɡ ˌi  o z l ˈi c a
καραγκιόζη|k ˌa r a ŋ ɡ i  ˈo z i
καρβουνιάζουνταν|k ˌa r v u ɲ ˈa z u d ˌa n
καρποί|k a r p ˈi
καρπος|k ˈa r p o s
καρποφορούσαν|k ˌa r p o f o r ˈu s a n
καρπούς|k a r p ˈu s
καρπό|k a r p ˈo
καρπός|k a r p ˈo s
καρτερούσε|k ˌa r t e r ˈu s e
καρτοτηλέφωνα|k ˌa r t o t i l ˈe f o n ˌa
καρφωμένη|k ˌa r f o m ˈe n i
καρφώσει|k a r f ˈo s i
καρότα|k a r ˈo t a
καστανά|k ˌa s t a n ˈa
κατάκλεβαν|k a t ˈa k l e v ˌa n
κατάλαβε|k a t ˈa l a v ˌe
κατάλαβες|k a t ˈa l a v ˌe s
κατάματα|k a t ˈa m a t ˌa
κατάντια|k a t ˈa d i  ˌa
κατάξερο|k a t ˈa k s e r ˌo
κατάξερος|k a t ˈa k s e r ˌo s
κατάσταση|k a t ˈa s t a s ˌi
κατάστιχο|k a t ˈa s t i x ˌo
κατάφεραν|k a t ˈa f e r ˌa n
κατάφερε|k a t ˈa f e r ˌe
κατάφερες|k a t ˈa f e r ˌe s
κατάφθανε|k a t ˈa f θ a n ˌe
κατάφυτα|k a t ˈa f i t ˌa
κατάφυτη|k a t ˈa f i t ˌi
κατάφυτο|k a t ˈa f i t ˌo
κατάχλωμο|k a t ˈa x l o m ˌo
κατέβαζαν|k a t ˈe v a z ˌa n
κατέβαζε|k a t ˈe v a z ˌe
κατέβαινα|k a t ˈe v e n ˌa
κατέβαιναν|k a t ˈe v e n ˌa n
κατέβαινε|k a t ˈe v e n ˌe
κατέβασα|k a t ˈe v a s ˌa
κατέβασε|k a t ˈe v a s ˌe
κατέβει|k a t ˈe v i
κατέβηκα|k a t ˈe v i k ˌa
κατέβηκαν|k a t ˈe v i k ˌa n
κατέβηκε|k a t ˈe v i c ˌe
κατέβω|k a t ˈe v o
κατέστρεψες|k a t ˈe s t r e p s ˌe s
κατήντησε|k a t ˈi d i s ˌe
καταγής|k ˌa t a j ˈi s
καταγί|k ˌa t a j ˈi
καταγίνεσαι|k ˌa t a j ˈi n e s ˌe
καταγίνεται|k ˌa t a j ˈi n e t ˌe
καταγίνουνταν|k ˌa t a j ˈi n u d ˌa n
καταγίνω|k ˌa t a j ˈi n o
καταγγείλει|k ˌa t a ŋ ɡ ˈi l i
καταγραμμένοι|k ˌa t a ɣ r a m ˈe n i
καταγραμμένους|k ˌa t a ɣ r a m ˈe n u s
καταγραφές|k ˌa t a ɣ r a f ˈe s
καταδέξου|k ˌa t a ð ˈe k s u
καταδέχεσαι|k ˌa t a ð ˈe ç e s ˌe
καταδίκασε|k ˌa t a ð ˈi k a s ˌe
καταδίκη|k ˌa t a ð ˈi c i
καταδεχθώ|k ˌa t a ð e x θ ˈo
καταδικάζει|k ˌa t a ð i k ˈa z i
καταδικάζω|k ˌa t a ð i k ˈa z o
καταδικάσει|k ˌa t a ð i k ˈa s i
καταδικασμένο|k ˌa t a ð ˌi k a s m ˈe n o
καταθλιμμένο|k ˌa t a θ l i m ˈe n o
κατακοκκίνισε|k ˌa t a k o c ˈi n i s ˌe
κατακομμένες|k ˌa t a k o m ˈe n e s
κατακουρελιασμένος|k ˌa t a k ˌu r e ʎ a s m ˈe n o s
κατακτήσει|k ˌa t a k t ˈi s i
κατακτήσω|k ˌa t a k t ˈi s o
κατακόκκινα|k ˌa t a k ˈo c i n ˌa
κατακόκκινες|k ˌa t a k ˈo c i n ˌe s
κατακόκκινη|k ˌa t a k ˈo c i n ˌi
κατακόκκινος|k ˌa t a k ˈo c i n ˌo s
καταλάβει|k ˌa t a l ˈa v i
καταλάβεις|k ˌa t a l ˈa v i s
καταλάβουν|k ˌa t a l ˈa v u n
καταλαβαίνει|k ˌa t a l a v ˈe n i
καταλαβαίνεις|k ˌa t a l a v ˈe n i s
καταπάνω|k ˌa t a p ˈa n o
καταπιαστώ|k ˌa t a p ç a s t ˈo
καταπράσινα|k ˌa t a p r ˈa s i n ˌa
καταραμένο|k ˌa t a r a m ˈe n o
κατασκονισμένος|k ˌa t a s k ˌo n i s m ˈe n o s
κατασκότεινο|k ˌa t a s k ˈo t i n ˌo
καταστολή|k ˌa t a s t o l ˈi
καταστράφηκε|k ˌa t a s t r ˈa f i c ˌe
καταστρέφεται|k ˌa t a s t r ˈe f e t ˌe
καταστρέφουν|k ˌa t a s t r ˈe f u n
καταστρέψει|k ˌa t a s t r ˈe p s i
καταστρέψομε|k ˌa t a s t r ˈe p s o m ˌe
καταστρέψουν|k ˌa t a s t r ˈe p s u n
καταστραφεί|k ˌa t a s t r a f ˈi
κατατάξει|k ˌa t a t ˈa k s i
κατατρομαγμένου|k ˌa t a t r ˌo m a ɣ m ˈe n u
καταφέρομε|k ˌa t a f ˈe r o m ˌe
καταφθάνουν|k ˌa t a f θ ˈa n u n
καταφρονήσει|k ˌa t a f r o n ˈi s i
καταφύγει|k ˌa t a f ˈi j i
καταχαρούμενο|k ˌa t a x a r ˈu m e n ˌo
καταχαρούμενοι|k ˌa t a x a r ˈu m e n ˌi
καταχαρούμενος|k ˌa t a x a r ˈu m e n ˌo s
καταχτήσει|k ˌa t a x t ˈi s i
κατεβάζει|k ˌa t e v ˈa z i
κατεβάζω|k ˌa t e v ˈa z o
κατεβάσει|k ˌa t e v ˈa s i
κατεβαίνοντας|k ˌa t e v ˈe n o d ˌa s
κατεβαίνουν|k ˌa t e v ˈe n u n
κατεβούμε|k ˌa t e v ˈu m e
κατεργαρίσκο|k ˌa t e r ɣ a r ˈi s k o
κατεργαρίσκος|k ˌa t e r ɣ a r ˈi s k o s
κατευθείαν|k ˌa t e f θ ˈi  a n
κατευθύνθηκε|k ˌa t e f θ ˈi n θ i c ˌe
κατεύθυνση|k a t ˈe f θ i n s ˌi
κατοικήσιμος|k ˌa t i c ˈi s i m ˌo s
κατοικήσουν|k ˌa t i c ˈi s u n
κατοικημένα|k ˌa t i c i m ˈe n a
κατοικημένη|k ˌa t i c i m ˈe n i
κατοικημένος|k ˌa t i c i m ˈe n o s
κατορθώσει|k ˌa t o r θ ˈo s i
κατρακυλάκο|k ˌa t r a c i l ˈa k o
κατρακυλάκος|k ˌa t r a c i l ˈa k o s
κατρακυλάκου|k ˌa t r a c i l ˈa k u
κατρακυλιστά|k ˌa t r a c ˌi l i s t ˈa
κατρακυλούσαν|k ˌa t r a c i l ˈu s a n
κατρακυλούσε|k ˌa t r a c i l ˈu s e
κατρακύλησα|k ˌa t r a c ˈi l i s ˌa
κατρακύλησε|k ˌa t r a c ˈi l i s ˌe
κατρακύλι|k ˌa t r a c ˈi l i
κατρακύλια|k ˌa t r a c ˈi ʎ a
κατσίκες|k a ts ˈi c e s
κατσίκι|k a ts ˈi c i
κατσίκια|k a ts ˈi c a
κατσαρόλες|k ˌa ts a r ˈo l e s
κατσουφιασμένες|k ˌa ts u f ˌi  a s m ˈe n e s
κατσουφιασμένο|k ˌa ts u f ˌi  a s m ˈe n o
κατσουφιασμένος|k ˌa ts u f ˌi  a s m ˈe n o s
κατόρθωσε|k a t ˈo r θ o s ˌe
κατώφλι|k a t ˈo f l i
καφάσια|k a f ˈa s j a
καφέ|k a f ˈe
καφές|k a f ˈe s
καφενείου|k ˌa f e n ˈi  u
κείνα|c ˈi n a
κείνο|c ˈi n o
κείνους|c ˈi n u s
κείτουνταν|c ˈi t u d ˌa n
κει|c ˈi
κελάρι|c e l ˈa r i
κελάρι·|c e l ˈa r i
κελαριού|c ˌe l a r i  ˈu
κεντήματα|c e d ˈi m a t ˌa
κεντημένη|c ˌe d i m ˈe n i
κεραμιδί|c ˌe r a m i ð ˈi
κερασιές|c ˌe r a s j ˈe s
κερδίζαμε|c e r ð ˈi z a m ˌe
κερδίζουν|c e r ð ˈi z u n
κερδισμένο|c ˌe r ð i s m ˈe n o
κεφάλι|c e f ˈa l i
κεφάλια|c e f ˈa ʎ a
κεφαλιού|c ˌe f a ʎ ˈu
κηπαράκι|c ˌi p a r ˈa c i
κηρύσσουμε|c i r ˈi s s u m ˌe
κι|c ˈi
κια|c ˈa
κιλά|c i l ˈa
κινδυνεύουν|c ˌi n ð i n ˈe v u n
κινδύνου|c i n ð ˈi n u
κινητό|c ˌi n i t ˈo
κιτρινιασμένα|c ˌi t r i ɲ a s m ˈe n a
κιόλα|c ˈo l a
κλάματα|k l ˈa m a t ˌa
κλέ|k l ˈe
κλέβουν|k l ˈe v u n
κλέφτες|k l ˈe f t e s
κλέφτη|k l ˈe f t i
κλέφτης|k l ˈe f t i s
κλέψανε|k l ˈe p s a n ˌe
κλέψει|k l ˈe p s i
κλέψουν|k l ˈe p s u n
κλήμα|k l ˈi m a
κλήματα|k l ˈi m a t ˌa
κλήσης|k l ˈi s i s
κλαίει|k l ˈe i
κλαδέψει|k l a ð ˈe p s i
κλαδί|k l a ð ˈi
κλαδιά|k l ˌa ð i  ˈa
κλαις|k l ˈe s
κλαύθηκε|k l ˈa f θ i c ˌe
κλείδωσε|k l ˈi ð o s ˌe
κλείσε|k l ˈi s e
κλείσει|k l ˈi s i
κλείσουν|k l ˈi s u n
κλειδάκι|k l i ð ˈa c i
κλειδί|k l i ð ˈi
κλειδαράδες|k l ˌi ð a r ˈa ð e s
κλειδαριά|k l ˌi ð a r i  ˈa
κλειδιά|k l ˌi ð i  ˈa
κλειδώσει|k l i ð ˈo s i
κλεισμένος|k l i s m ˈe n o s
κλειστό|k l i s t ˈo
κλεμμένα|k l e m ˈe n a
κλεμμένο|k l e m ˈe n o
κλεπταποδόχος|k l ˌe p t a p o ð ˈo x o s
κλεφταποδόχος|k l ˌe f t a p o ð ˈo x o s
κλεφτόπαιδο|k l e f t ˈo p e ð ˌo
κλεψιές|k l ˌe p s i  ˈe s
κλονίστηκε|k l o n ˈi s t i c ˌe
κλονούμενα|k l o n ˈu m e n ˌa
κλωνάρια|k l o n ˈa r i  ˌa
κλωστές|k l o s t ˈe s
κλωστή|k l o s t ˈi
κλωτσιά|k l ˌo ts i  ˈa
κλώσετε|k l ˈo s e t ˌe
κλώσουν|k l ˈo s u n
κλώτσησε|k l ˈo ts i s ˌe
κοίταζα|c ˈi t a z ˌa
κοίταζαν|c ˈi t a z ˌa n
κοίταζε|c ˈi t a z ˌe
κοίταξαν|c ˈi t a k s ˌa n
κοίταξε|c ˈi t a k s ˌe
κοιμάται|c i m ˈa t e
κοιμήθηκαν|c i m ˈi θ i k ˌa n
κοιμήθηκε|c i m ˈi θ i c ˌe
κοιμήσου|c i m ˈi s u
κοιμηθεί|c ˌi m i θ ˈi
κοιμηθείς|c ˌi m i θ ˈi s
κοιμηθούμε|c ˌi m i θ ˈu m e
κοιμηθούν|c ˌi m i θ ˈu n
κοιμηθώ|c ˌi m i θ ˈo
κοιμισμένη|c ˌi m i s m ˈe n i
κοιμισμένο|c ˌi m i s m ˈe n o
κοιμούνταν|c i m ˈu d a n
κοινότητα|c i n ˈo t i t ˌa
κοιτάζει|c i t ˈa z i
κοιτάζοντας|c i t ˈa z o d ˌa s
κοιτάξει|c i t ˈa k s i
κοιτάξετε|c i t ˈa k s e t ˌe
κοιτάς|c i t ˈa s
κοκκίνιζαν|k o c ˈi n i z ˌa n
κοκκίνιζε|k o c ˈi n i z ˌe
κοκκίνισε|k o c ˈi n i s ˌe
κοκκινάδα|k ˌo c i n ˈa ð a
κολακευτικά|k ˌo l a c ˌe f t i k ˈa
κολακεύεις|k ˌo l a c ˈe v i s
κολοκύθια|k ˌo l o c ˈi θ i  ˌa
κομμάτι|k o m ˈa t i
κομμάτιαζε|k o m ˈa t i  ˌa z e
κομμένες|k o m ˈe n e s
κομμένους|k o m ˈe n u s
κομπολόγι|k ˌo b o l ˈo j i
κομψό|k o m p s ˈo
κονσόλα|k o n s ˈo l a
κοντά|k o d ˈa
κοντάρι|k o d ˈa r i
κοντάρια|k o d ˈa r i  ˌa
κοντοστάθηκαν|k ˌo d o s t ˈa θ i k ˌa n
κοντοστάθηκε|k ˌo d o s t ˈa θ i c ˌe
κοντός|k o d ˈo s
κοπάδι|k o p ˈa ð i
κοπάδια|k o p ˈa ð j a
κοπέλα|k o p ˈe l a
κοπέλι|k o p ˈe l i
κοπελίτσα|k ˌo p e l ˈi ts a
κοπελιά|k ˌo p e ʎ ˈa
κοπιάζεις|k o p ç ˈa z i s
κοπιάστε|k o p ç ˈa s t e
κορίτσι|k o r ˈi ts i
κορδέλες|k o r ð ˈe l e s
κορδόνια|k o r ð ˈo ɲ a
κοριτσίστικο|k ˌo r i ts ˈi s t i k ˌo
κοριτσιών|k ˌo r i ts i  ˈo n
κορμί|k o r m ˈi
κορμούς|k o r m ˈu s
κορμό|k o r m ˈo
κορμός|k o r m ˈo s
κοροϊδευτικά|k ˌo r oɪ ð ˌe f t i k ˈa
κοροϊδεύει|k ˌo r oɪ ð ˈe v i
κοροϊδεύεις|k ˌo r oɪ ð ˈe v i s
κοροϊδεύω|k ˌo r oɪ ð ˈe v o
κορυφή|k ˌo r i f ˈi
κορωνα|k o r ˈo n a
κορώνα|k o r ˈo n a
κορώνας|k o r ˈo n a s
κοταριό|k ˌo t a r i  ˈo
κοτόπουλου|k o t ˈo p u l ˌu
κουβά|k u v ˈa
κουβάλησαν|k u v ˈa l i s ˌa n
κουβάρι|k u v ˈa r i
κουβέντιαζαν|k u v ˈe d i  ˌa z a n
κουβέντιαζε|k u v ˈe d i  ˌa z e
κουβέρτα|k u v ˈe r t a
κουβαλά|k ˌu v a l ˈa
κουβαλούσαν|k ˌu v a l ˈu s a n
κουβαλούσε|k ˌu v a l ˈu s e
κουβαλώντας|k ˌu v a l ˈo d a s
κουβεντιάζοντας|k ˌu v e d i  ˈa z o d ˌa s
κουβούκλιο|k u v ˈu k ʎ o
κουδουνίζοντας|k ˌu ð u n ˈi z o d ˌa s
κουδουνίζω|k ˌu ð u n ˈi z o
κουδουνίσματα|k ˌu ð u n ˈi s m a t ˌa
κουδούνι|k u ð ˈu n i
κουδούνιζε|k u ð ˈu n i z ˌe
κουδούνισμα|k u ð ˈu n i s m ˌa
κουζίνα|k u z ˈi n a
κουζίνας|k u z ˈi n a s
κουιούνταν|k ˌu i  ˈu d a n
κουκάκης|k u k ˈa c i s
κουκίδη|k u c ˈi ð i
κουκίδης|k u c ˈi ð i s
κουκιά|k u c ˈa
κουκλίστικο|k u k l ˈi s t i k ˌo
κουκουβάγια|k ˌu k u v ˈa j a
κουκόπουλο|k u k ˈo p u l ˌo
κουκόπουλος|k u k ˈo p u l ˌo s
κουλουριασμένο|k ˌu l u r ˌi  a s m ˈe n o
κουλού|k u l ˈu
κουλούριασε|k u l ˈu r i  ˌa s e
κουλό|k u l ˈo
κουλός|k u l ˈo s
κουμνιά|k u m ɲ ˈa
κουμπί|k u b ˈi
κουνέλια|k u n ˈe ʎ a
κουνήσει|k u n ˈi s i
κουνήσουν|k u n ˈi s u n
κουνελάκι|k ˌu n e l ˈa c i
κουνιούνταν|k u ɲ ˈu d a n
κουντουράς|k ˌu d u r ˈa s
κουράγιο|k u r ˈa j o
κουρέλιασμα|k u r ˈe ʎ a s m ˌa
κουρασμένα|k ˌu r a s m ˈe n a
κουρασμένος|k ˌu r a s m ˈe n o s
κουρελιάρηδες|k ˌu r e ʎ ˈa r i ð ˌe s
κουρελιασμένα|k ˌu r e ʎ a s m ˈe n a
κουρελιασμένη|k ˌu r e ʎ a s m ˈe n i
κουρελιασμένο|k ˌu r e ʎ a s m ˈe n o
κουρελιασμένοι|k ˌu r e ʎ a s m ˈe n i
κουρτινάκια|k ˌu r t i n ˈa c a
κουτή|k u t ˈi
κουτί|k u t ˈi
κουτεντέ|k ˌu t e d ˈe
κουτρουβαλιστά|k ˌu t r u v ˌa l i s t ˈa
κουτσή|k u ts ˈi
κουτσοζεί|k ˌu ts o z ˈi
κουτσοστέκουνταν|k ˌu ts o s t ˈe k u d ˌa n
κουτσός|k u ts ˈo s
κουτός|k u t ˈo s
κουφούς|k u f ˈu s
κοφίνι|k o f ˈi n i
κοφίνια|k o f ˈi ɲ a
κοφτερό|k ˌo f t e r ˈo
κούκος|k ˈu k o s
κούμαρα|k ˈu m a r ˌa
κούνησε|k ˈu n i s ˌe
κούραση|k ˈu r a s ˌi
κούρευαν|k ˈu r e v ˌa n
κούτσα|k ˈu ts a
κούτσουρο|k ˈu ts u r ˌo
κράτος|k r ˈa t o s
κράτους|k r ˈa t u s
κράτους»|k r ˈa t u s
κρέας|k r ˈe a s
κρέμασε|k r ˈe m a s ˌe
κρέμουνταν|k r ˈe m u d ˌa n
κρίμα|k r ˈi m a
κρασάδικο|k r a s ˈa ð i k ˌo
κρασί|k r a s ˈi
κρατήθηκε|k r a t ˈi θ i c ˌe
κρατούσε|k r a t ˈu s e
κρατώντας|k r a t ˈo d a s
κρεβάτι|k r e v ˈa t i
κρεβατοκάμαρα|k r ˌe v a t o k ˈa m a r ˌa
κρεμάσει|k r e m ˈa s i
κρεμάσω|k r e m ˈa s o
κρεμασμένο|k r ˌe m a s m ˈe n o
κρεμασμένος|k r ˌe m a s m ˈe n o s
κρεμαστά|k r ˌe m a s t ˈa
κρεμαστάρι|k r ˌe m a s t ˈa r i
κρεμαστή|k r ˌe m a s t ˈi
κρεμαστείς|k r ˌe m a s t ˈi s
κρεμμύδια|k r e m ˈi ð j a
κρυμμένος|k r i m ˈe n o s
κρυσταλλένια|k r ˌi s t a l ˈe ɲ a
κρυφθήκαμε|k r i f θ ˈi k a m ˌe
κρυφοσκούπισε|k r ˌi f o s k ˈu p i s ˌe
κρυώσει|k r i  ˈo s i
κρότο|k r ˈo t o
κρότος|k r ˈo t o s
κρύβεσαι|k r ˈi v e s ˌe
κρύβεται|k r ˈi v e t ˌe
κρύβονται|k r ˈi v o d ˌe
κρύβοντας|k r ˈi v o d ˌa s
κρύβουν|k r ˈi v u n
κρύβουνταν|k r ˈi v u d ˌa n
κρύο|k r ˈi  o
κρύφθηκαν|k r ˈi f θ i k ˌa n
κρύφθηκε|k r ˈi f θ i c ˌe
κρύψει|k r ˈi p s i
κρύωσαν|k r ˈi  o s ˌa n
κτήμα|k t ˈi m a
κυβέρνα|c i v ˈe r n a
κυβέρνηση|c i v ˈe r n i s ˌi
κυβερνά|c ˌi v e r n ˈa
κυβερνάς|c ˌi v e r n ˈa s
κυβερνήσεις|c ˌi v e r n ˈi s i s
κυβερνήσετε|c ˌi v e r n ˈi s e t ˌe
κυβερνήτες|c ˌi v e r n ˈi t e s
κυβερνήτης|c ˌi v e r n ˈi t i s
κυλήσει|c i l ˈi s i
κυλίστηκε|c i l ˈi s t i c ˌe
κυλιόμενος|c i ʎ ˈo m e n ˌo s
κυλούσαν|c i l ˈu s a n
κυλώντας|c i l ˈo d a s
κυνήγησε|c i n ˈi j i s ˌe
κυνήγι|c i n ˈi j i
κυνηγάει|c ˌi n i ɣ ˈa i
κυνηγάς|c ˌi n i ɣ ˈa s
κυνηγητό|c ˌi n i j i t ˈo
κυνηγούσα|c ˌi n i ɣ ˈu s a
κυνηγούσε|c ˌi n i ɣ ˈu s e
κυνηγώ|c ˌi n i ɣ ˈo
κυνηγώντας|c ˌi n i ɣ ˈo d a s
κυπρί|c i p r ˈi
κυπριά|c ˌi p r i  ˈa
κυπριού|c ˌi p r i  ˈu
κυπριών|c ˌi p r i  ˈo n
κυρ|c ˈi r
κυρά|c i r ˈa
κυρα|c ˈi r a
κυραρχικαγκελάριος|c ˌi r a r ç ˌi k a ŋ ɡ e l ˈa r i  ˌo s
κυρδάσκαλε|c i r ð ˈa s k a l ˌe
κυψέλες|c i p s ˈe l e s
κυψέλη|c i p s ˈe l i
κόβαμε|k ˈo v a m ˌe
κόβοντας|k ˈo v o d ˌa s
κόβουν|k ˈo v u n
κόκαλα|k ˈo k a l ˌa
κόκκινο|k ˈo c i n ˌo
κόκκινος|k ˈo c i n ˌo s
κόμμα|k ˈo m a
κόμπο|k ˈo b o
κόμποι|k ˈo b i
κόμπους|k ˈo b u s
κόντεψε|k ˈo d e p s ˌe
κόπηκαν|k ˈo p i k ˌa n
κόπηκε|k ˈo p i c ˌe
κόπο|k ˈo p o
κόπος|k ˈo p o s
κόρες|k ˈo r e s
κόρη|k ˈo r i
κόρης|k ˈo r i s
κόρφο|k ˈo r f o
κόσκινο|k ˈo s c i n ˌo
κόσμο|k ˈo s m o
κόσμον|k ˈo s m o n
κόσμος|k ˈo s m o s
κόσμου|k ˈo s m u
κόσμους|k ˈo s m u s
κόστιζε|k ˈo s t i z ˌe
κότες|k ˈo t e s
κότσο|k ˈo ts o
κότσυφα|k ˈo ts i f ˌa
κότσυφας|k ˈo ts i f ˌa s
κόψανε|k ˈo p s a n ˌe
κόψε|k ˈo p s e
κόψει|k ˈo p s i
κόψουν|k ˈo p s u n
κόψω|k ˈo p s o
κύκλο|c ˈi k l o
κύριε|c ˈi r i  ˌe
κώθηκε|k ˈo θ i c ˌe
κ’|k ˈa p a
λάθος|l ˈa θ o s
λάκκους|l ˈa k u s
λάπτοπ|l ˈa p t o p
λέγε|l ˈe j e
λέγοντας|l ˈe ɣ o d ˌa s
λέγω|l ˈe ɣ o
λένε|l ˈe n e
λέξεις|l ˈe k s i s
λές|l ˈe s
λήθαργο|l ˈi θ a r ɣ ˌo
λίγα|l ˈi ɣ a
λίγες|l ˈi j e s
λίγη|l ˈi j i
λίγο|l ˈi ɣ o
λίγοι|l ˈi j i
λίγους|l ˈi ɣ u s
λίμνη|l ˈi m n i
λαίμαργες|l ˈe m a r j ˌe s
λαβώθηκες|l a v ˈo θ i c ˌe s
λαγκάδια|l a ŋ ɡ ˈa ð j a
λαγοί|l a j ˈi
λαγούς|l a ɣ ˈu s
λαγό|l a ɣ ˈo
λαγόκαρδε|l a ɣ ˈo k a r ð ˌe
λαγόκαρδο|l a ɣ ˈo k a r ð ˌo
λαγόκαρδος|l a ɣ ˈo k a r ð ˌo s
λαγόκαρδος»|l a ɣ ˈo k a r ð ˌo s
λαγόκαρδου|l a ɣ ˈo k a r ð ˌu
λαιμού|l e m ˈu
λαιμό|l e m ˈo
λαιμός|l e m ˈo s
λαμπάδα|l a b ˈa ð a
λαμπάδες|l a b ˈa ð e s
λαμπρά|l a b r ˈa
λαμπρό|l a b r ˈo
λαούς|l a ˈu s
λαργάρετε|l a r ɣ ˈa r e t ˌe
λαρύγγι|l a r ˈi ŋ ɡ i
λαφριά|l ˌa f r i  ˈa
λαφρύς|l a f r ˈi s
λαχανιασμένο|l ˌa x a ɲ a s m ˈe n o
λαχανιασμένος|l ˌa x a ɲ a s m ˈe n o s
λαχανικά|l ˌa x a n i k ˈa
λαχανικά·|l ˌa x a n i k ˈa
λαχτάρα|l a x t ˈa r a
λαό|l a ˈo
λαός|l a ˈo s
λείπει|l ˈi p i
λείπουν|l ˈi p u n
λεβέντη|l e v ˈe d i
λεκέ|l e c ˈe
λεκέδες|l e c ˈe ð e s
λεκές|l e c ˈe s
λεν|l ˈe n
λεοντάρι|l ˌe o d ˈa r i
λεοντάρια|l ˌe o d ˈa r i  ˌa
λεονταράκι|l ˌe o d a r ˈa c i
λεπτά|l e p t ˈa
λεπτομέρειες|l ˌe p t o m ˈe r ç e s
λες|l ˈe s
λευκή|l e f c ˈi
λεφτά|l e f t ˈa
λεωφορείο|l ˌe o f o r ˈi  o
λεωφορείου|l ˌe o f o r ˈi  u
λεύκα|l ˈe f k a
λιακάδα|ʎ a k ˈa ð a
λιβάδια|l i v ˈa ð j a
λιγνό|l i ɣ n ˈo
λιγοστά|l ˌi ɣ o s t ˈa
λιθάρια|l i θ ˈa r i  ˌa
λιποταξία|l ˌi p o t a k s ˈi  a
λιωμένα|ʎ o m ˈe n a
λιωμένο|ʎ o m ˈe n o
λιώσουν|ʎ ˈo s u n
λογάριαζε|l o ɣ ˈa r i  ˌa z e
λογάριασα|l o ɣ ˈa r i  ˌa s a
λογής|l o j ˈi s
λογαριασμούς|l ˌo ɣ a r ˌi  a s m ˈu s
λογαριασμό|l ˌo ɣ a r ˌi  a s m ˈo
λογαριαστείς|l ˌo ɣ a r ˌi  a s t ˈi s
λογικό|l ˌo j i k ˈo
λογιότατε|l o j ˈo t a t ˌe
λογχοφόροι|l ˌo ŋ x o f ˈo r i
λοιπά|l i p ˈa
λοιπόν|l i p ˈo n
λουλουδάκια|l ˌu l u ð ˈa c a
λουλούδια|l u l ˈu ð j a
λουρί|l u r ˈi
λουτρά|l u t r ˈa
λούφαξε|l ˈu f a k s ˌe
λυγίσει|l i j ˈi s i
λυγερή|l ˌi j e r ˈi
λυγισμένος|l ˌi j i s m ˈe n o s
λυγμούς|l i ɣ m ˈu s
λυπάσαι|l i p ˈa s e
λυπήθηκε|l i p ˈi θ i c ˌe
λυπήσου|l i p ˈi s u
λυπημένα|l ˌi p i m ˈe n a
λυπούνται|l i p ˈu d e
λυσσασμένους|l ˌi s s a s m ˈe n u s
λόγγους|l ˈo ŋ ɡ u s
λόγια|l ˈo j a
λόγο|l ˈo ɣ o
λόγος|l ˈo ɣ o s
λόγου|l ˈo ɣ u
λόγχες|l ˈo ŋ ç e s
λόγχες»|l ˈo ŋ ç e s
λόγχη|l ˈo ŋ ç i
λόφους|l ˈo f u s
λύθηκαν|l ˈi θ i k ˌa n
λύκος|l ˈi k o s
λύπη|l ˈi p i
μ'|m ˈi
μάγειρα|m ˈa j i r ˌa
μάγειρας|m ˈa j i r ˌa s
μάγειροι|m ˈa j i r ˌi
μάγουλα|m ˈa ɣ u l ˌa
μάδησε|m ˈa ð i s ˌe
μάζευαν|m ˈa z e v ˌa n
μάζεψαν|m ˈa z e p s ˌa n
μάθαιναν|m ˈa θ e n ˌa n
μάθαινε|m ˈa θ e n ˌe
μάθαμε|m ˈa θ a m ˌe
μάθε|m ˈa θ e
μάθει|m ˈa θ i
μάθεις|m ˈa θ i s
μάθετε|m ˈa θ e t ˌe
μάθημα|m ˈa θ i m ˌa
μάθημα·|m ˈa θ i m ˌa
μάθομε|m ˈa θ o m ˌe
μάθουν|m ˈa θ u n
μάθω|m ˈa θ o
μάλιστα|m ˈa l i s t ˌa
μάλλινα|m ˈa l i n ˌa
μάλλον|m ˈa l o n
μάνα|m ˈa n a
μάντρα|m ˈa d r a
μάντρες|m ˈa d r e s
μάραινε|m ˈa r e n ˌe
μάρανε|m ˈa r a n ˌe
μάρτυρας|m ˈa r t i r ˌa s
μάταια|m ˈa t e ˌa
μάτι|m ˈa t i
μάτσα|m ˈa ts a
μάτσο|m ˈa ts o
μάτωνε|m ˈa t o n ˌe
μάχη|m ˈa ç i
μέγαιρα|m ˈe j e r ˌa
μέλει|m ˈe l i
μέλι|m ˈe l i
μέλισσα|m ˈe l i s s ˌa
μέλισσας|m ˈe l i s s ˌa s
μέλισσες|m ˈe l i s s ˌe s
μέλλον|m ˈe l o n
μένα|m ˈe n a
μένει|m ˈe n i
μένετε|m ˈe n e t ˌe
μένουν|m ˈe n u n
μέρα|m ˈe r a
μέρανύχτα|m ˈe r a n ˈi x t a
μέρες|m ˈe r e s
μέρη|m ˈe r i
μέρος|m ˈe r o s
μέρος·|m ˈe r o s
μέση|m ˈe s i
μέταλλο|m ˈe t a l ˌo
μέτριο|m ˈe t r i  ˌo
μέτρων|m ˈe t r o n
μέτωπο|m ˈe t o p ˌo
μήλα|m ˈi l a
μήνα|m ˈi n a
μήνες|m ˈi n e s
μήπως|m ˈi p o s
μήτε|m ˈi t e
μήτσο|m ˈi ts o
μήτσος|m ˈi ts o s
μίλησαν|m ˈi l i s ˌa n
μίλησε|m ˈi l i s ˌe
μίλια|m ˈi ʎ a
μα|m ˈa
μαγαζιού|m ˌa ɣ a z j ˈu
μαγείρεμα|m a j ˈi r e m ˌa
μαγείρεψες|m a j ˈi r e p s ˌe s
μαγείρισσα|m a j ˈi r i s s ˌa
μαγειρεύουν|m ˌa j i r ˈe v u n
μαγειρεύω|m ˌa j i r ˈe v o
μαγειριού|m ˌa j i r i  ˈu
μαγειριό|m ˌa j i r i  ˈo
μαγκωμένος|m ˌa ŋ ɡ o m ˈe n o s
μαδούσε|m a ð ˈu s e
μαζέψει|m a z ˈe p s i
μαζέψετε|m a z ˈe p s e t ˌe
μαζέψομε|m a z ˈe p s o m ˌe
μαζέψουν|m a z ˈe p s u n
μαζέψω|m a z ˈe p s o
μαζί|m a z ˈi
μαζεμένες|m ˌa z e m ˈe n e s
μαζεμένη|m ˌa z e m ˈe n i
μαζεμένο|m ˌa z e m ˈe n o
μαζεμένοι|m ˌa z e m ˈe n i
μαζεμένος|m ˌa z e m ˈe n o s
μαζεμένους|m ˌa z e m ˈe n u s
μαζευθεί|m ˌa z e f θ ˈi
μαζεύει|m a z ˈe v i
μαζεύεις|m a z ˈe v i s
μαζεύομε|m a z ˈe v o m ˌe
μαζεύοντας|m a z ˈe v o d ˌa s
μαζεύουν|m a z ˈe v u n
μαθαίνει|m a θ ˈe n i
μαθαίνεις|m a θ ˈe n i s
μαθαίνουν|m a θ ˈe n u n
μαθητές|m ˌa θ i t ˈe s
μακριά|m ˌa k r i  ˈa
μακροβουτιού|m ˌa k r o v ˌu t i  ˈu
μακρύ|m a k r ˈi
μακρύς|m a k r ˈi s
μακρύτερα|m a k r ˈi t e r ˌa
μαλλιά|m a ʎ ˈa
μαλλιοκουβαριαστήκαμε|m ˌa ʎ o k ˌu v a r ˌi  a s t ˈi k a m ˌe
μαλώματα|m a l ˈo m a t ˌa
μαλώνει|m a l ˈo n i
μαλώσουν|m a l ˈo s u n
μαμούνια|m a m ˈu ɲ a
μανία|m a n ˈi  a
μανίκι|m a n ˈi c i
μανίκια|m a n ˈi c a
μανδύα|m a n ð ˈi  a
μανιασμένη|m ˌa ɲ a s m ˈe n i
μανούλα|m a n ˈu l a
μαντίλι|m a d ˈi l i
μαντίλια|m a d ˈi ʎ a
μαντιλιού|m ˌa d i ʎ ˈu
μαντιλοδεμένο|m ˌa d i l ˌo ð e m ˈe n o
μαξίμ|m a k s ˈi m
μαξιλάρι|m ˌa k s i l ˈa r i
μαξιλάρια|m ˌa k s i l ˈa r i  ˌa
μαραίνεσαι|m a r ˈe n e s ˌe
μαραγκοί|m ˌa r a ŋ ɡ ˈi
μαραγκούς|m ˌa r a ŋ ɡ ˈu s
μαραμένη|m ˌa r a m ˈe n i
μαραμένο|m ˌa r a m ˈe n o
μαρμαρίου|m ˌa r m a r ˈi  u
μαρμαρωμένα|m ˌa r m a r o m ˈe n a
μαρούλια|m a r ˈu ʎ a
μαρτυρούσαν|m ˌa r t i r ˈu s a n
μας|m ˈa s
μας»|m ˈa s
μασκαράδες|m ˌa s k a r ˈa ð e s
μασκαρόπουλο|m ˌa s k a r ˈo p u l ˌo
μασκαρόπουλος|m ˌa s k a r ˈo p u l ˌo s
μασκαρόπουλου|m ˌa s k a r ˈo p u l ˌu
μασούσε|m a s ˈu s e
μαστίχα|m a s t ˈi x a
μασχάλες|m a s x ˈa l e s
ματάκια|m a t ˈa c a
ματιά|m ˌa t i  ˈa
ματιάς|m ˌa t i  ˈa s
ματιές|m ˌa t i  ˈe s
ματιού|m ˌa t i  ˈu
μαυρισμένες|m ˌa v r i s m ˈe n e s
μαχαίρι|m a ç ˈe r i
μαχαιριά|m ˌa ç e r i  ˈa
μαχη|m ˈa ç i
μαύρα|m ˈa v r a
μαύρες|m ˈa v r e s
μαύρη|m ˈa v r i
μαύρο|m ˈa v r o
μαύροι|m ˈa v r i
μαύρος|m ˈa v r o s
με|m ˈe
μείναμε|m ˈi n a m ˌe
μείνανε|m ˈi n a n ˌe
μείνει|m ˈi n i
μείνεις|m ˈi n i s
μείνετε|m ˈi n e t ˌe
μείνομε|m ˈi n o m ˌe
μείνουμε|m ˈi n u m ˌe
μείνουν|m ˈi n u n
μείνω|m ˈi n o
μεγάλα|m e ɣ ˈa l a
μεγάλες|m e ɣ ˈa l e s
μεγάλη|m e ɣ ˈa l i
μεγάλο|m e ɣ ˈa l o
μεγάλον|m e ɣ ˈa l o n
μεγάλος|m e ɣ ˈa l o s
μεγαλέμπορος|m ˌe ɣ a l ˈe b o r ˌo s
μεγαλείο|m ˌe ɣ a l ˈi  o
μεγαλοπρέπεια|m ˌe ɣ a l o p r ˈe p ç a
μεγαλόπρεπη|m ˌe ɣ a l ˈo p r e p ˌi
μεγαλόσταυρο|m ˌe ɣ a l ˈo s t a v r ˌo
μεγαλύτερα|m ˌe ɣ a l ˈi t e r ˌa
μεγαλύτερο|m ˌe ɣ a l ˈi t e r ˌo
μεγαλύτερον|m ˌe ɣ a l ˈi t e r ˌo n
μεγαλώσει|m ˌe ɣ a l ˈo s i
μεγαλώσουν|m ˌe ɣ a l ˈo s u n
μεγιστάνας|m ˌe j i s t ˈa n a s
μεγιστάνες|m ˌe j i s t ˈa n e s
μεθύσι|m e θ ˈi s i
μειλίχιο|m i l ˈi ç o
μεις|m ˈi s
μελάνιασε|m e l ˈa ɲ a s ˌe
μελέτησε|m e l ˈe t i s ˌe
μελίσσι|m e l ˈi s s i
μελίσσια|m e l ˈi s s j a
μελαγχολία|m ˌe l a ŋ x o l ˈi  a
μελαγχολικά|m ˌe l a ŋ x ˌo l i k ˈa
μελαχρινή|m ˌe l a x r i n ˈi
μελετήσει|m ˌe l e t ˈi s i
μελισσοφωλιές|m ˌe l i s s ˌo f o ʎ ˈe s
μελισσώνα|m ˌe l i s s ˈo n a
μελόπιτα|m e l ˈo p i t ˌa
μελόπιτες|m e l ˈo p i t ˌe s
μερδικό|m ˌe r ð i k ˈo
μεριά|m ˌe r i  ˈa
μεριές|m ˌe r i  ˈe s
μερικά|m ˌe r i k ˈa
μερικές|m ˌe r i c ˈe s
μερικούς|m ˌe r i k ˈu s
μερμήγκι|m e r m ˈi ŋ ɡ i
μερμήγκια|m e r m ˈi ŋ ɡ i  ˌa
μερμηγκιάζει|m ˌe r m i ŋ ɡ i  ˈa z i
μερμηγκιών|m ˌe r m i ŋ ɡ i  ˈo n
μεροδούλι|m ˌe r o ð ˈu l i
μεροφάγι|m ˌe r o f ˈa j i
μερτικό|m ˌe r t i k ˈo
μες|m ˈe s
μεσάνυχτα|m e s ˈa n i x t ˌa
μεσημέρι|m ˌe s i m ˈe r i
μεσημεριού|m ˌe s i m ˌe r i  ˈu
μεσόκοπος|m e s ˈo k o p ˌo s
μετά|m e t ˈa
μετέφερναν|m e t ˈe f e r n ˌa n
μετακινήθηκε|m ˌe t a c i n ˈi θ i c ˌe
μετακομίσει|m ˌe t a k o m ˈi s i
μεταλλεία|m ˌe t a l ˈi  a
μεταλλείο|m ˌe t a l ˈi  o
μεταλλείου|m ˌe t a l ˈi  u
μετανοιώσαμε|m ˌe t a ɲ ˈo s a m ˌe
μεταξωτά|m ˌe t a k s o t ˈa
μεταξωτό|m ˌe t a k s o t ˈo
μεταξύ|m ˌe t a k s ˈi
μεταφέρνουν|m ˌe t a f ˈe r n u n
μεταφερθούν|m ˌe t a f e r θ ˈu n
μεταχειρίζεσαι|m ˌe t a ç i r ˈi z e s ˌe
μεταχειρίζουνταν|m ˌe t a ç i r ˈi z u d ˌa n
μεταχειρίστηκα|m ˌe t a ç i r ˈi s t i k ˌa
μεταχειρισμένα|m ˌe t a ç ˌi r i s m ˈe n a
μεταχειριστείς|m ˌe t a ç ˌi r i s t ˈi s
μεταχειριστούν|m ˌe t a ç ˌi r i s t ˈu n
μετρήθηκαν|m e t r ˈi θ i k ˌa n
μετρημένα|m ˌe t r i m ˈe n a
μετρώντας|m e t r ˈo d a s
μη|m ˈi
μηλιές|m i ʎ ˈe s
μην|m ˈi n
μητέρας|m i t ˈe r a s
μια|m ɲ ˈa
μιαν|m ˈi  a n
μιας|m ˈi  a s
μικρά|m i k r ˈa
μικρέ|m i k r ˈe
μικρές|m i k r ˈe s
μικρέψει|m i k r ˈe p s i
μικρέψουν|m i k r ˈe p s u n
μικρή|m i k r ˈi
μικροπρέπειες|m ˌi k r o p r ˈe p ç e s
μικρούλα|m i k r ˈu l a
μικρό|m i k r ˈo
μικρός|m i k r ˈo s
μικρότερα|m i k r ˈo t e r ˌa
μιλά|m i l ˈa
μιλάνε|m i l ˈa n e
μιλάς|m i l ˈa s
μιλήσει|m i l ˈi s i
μιλήσεις|m i l ˈi s i s
μιλήσουν|m i l ˈi s u n
μιλήσω|m i l ˈi s o
μιλούσε|m i l ˈu s e
μιλώντας|m i l ˈo d a s
μισά|m i s ˈa
μισή|m i s ˈi
μισοέτοιμη|m ˌi s o ˈe t i m ˌi
μισοί|m i s ˈi
μισογκρεμισμένο|m ˌi s o ŋ ɡ r ˌe m i s m ˈe n o
μισοθυμωμένος|m ˌi s o θ ˌi m o m ˈe n o s
μισοκίτρινο|m ˌi s o c ˈi t r i n ˌo
μισοκρυμμένη|m ˌi s o k r i m ˈe n i
μισομαύρο|m ˌi s o m ˈa v r o
μισοντυμένο|m ˌi s o d i m ˈe n o
μισοξαπλωμένοι|m ˌi s o k s ˌa p l o m ˈe n i
μισοξεραμένη|m ˌi s o k s ˌe r a m ˈe n i
μισοπεθαμένο|m ˌi s o p ˌe θ a m ˈe n o
μισοπεθαμένος|m ˌi s o p ˌe θ a m ˈe n o s
μισορημαγμένα|m ˌi s o r ˌi m a ɣ m ˈe n a
μισοσβησμένα|m ˌi s o s v i s m ˈe n a
μισοφαγωμένο|m ˌi s o f ˌa ɣ o m ˈe n o
μισοχαρούμενος|m ˌi s o x a r ˈu m e n ˌo s
μισός|m i s ˈo s
μνημόσυνο|m n i m ˈo s i n ˌo
μοίρα|m ˈi r a
μοίραζε|m ˈi r a z ˌe
μοίρασαν|m ˈi r a s ˌa n
μοίρασε|m ˈi r a s ˌe
μοιάζει|m i  ˈa z i
μοιράσει|m i r ˈa s i
μοιράσουν|m i r ˈa s u n
μοιρα|m ˈi r a
μοιρολάτρες|m ˌi r o l ˈa t r e s
μοιρολάτρων|m ˌi r o l ˈa t r o n
μοιρολατρών|m ˌi r o l a t r ˈo n
μοιρολογούσε|m ˌi r o l o ɣ ˈu s e
μολις|m ˈo l i s
μολυβόχαρτο|m ˌo l i v ˈo x a r t ˌo
μολύβι|m o l ˈi v i
μονάχα|m o n ˈa x a
μονάχος|m o n ˈa x o s
μοναχική|m ˌo n a ç i c ˈi
μοναχικό|m ˌo n a ç i k ˈo
μονοκόμματος|m ˌo n o k ˈo m a t ˌo s
μονοπάτια|m ˌo n o p ˈa t i  ˌa
μονοτονία|m ˌo n o t o n ˈi  a
μονοχέρη|m ˌo n o ç ˈe r i
μονοχέρης|m ˌo n o ç ˈe r i s
μονοχερης|m ˌo n o ç ˈe r i s
μορφή|m o r f ˈi
μου|m ˈu
μουδιασμένη|m ˌu ð i  a s m ˈe n i
μουδιασμένος|m ˌu ð i  a s m ˈe n o s
μουλάρια|m u l ˈa r i  ˌa
μουντός|m u d ˈo s
μουρμουρίζοντας|m ˌu r m u r ˈi z o d ˌa s
μουρμούριζαν|m u r m ˈu r i z ˌa n
μουρμούριζε|m u r m ˈu r i z ˌe
μουρμούρισαν|m u r m ˈu r i s ˌa n
μουρμούρισε|m u r m ˈu r i s ˌe
μουρμούρισμα|m u r m ˈu r i s m ˌa
μουσαφίρηδες|m ˌu s a f ˈi r i ð ˌe s
μουσαφιρέοι|m ˌu s a f i r ˈe i
μουσκεμένα|m ˌu s c e m ˈe n a
μουφλούζεψε|m u f l ˈu z e p s ˌe
μουχλιασμένα|m ˌu x ʎ a s m ˈe n a
μού|m ˈu
μούγκρισε|m ˈu ŋ ɡ r i s ˌe
μούδιασαν|m ˈu ð i  ˌa s a n
μπάγκο|b ˈa ŋ ɡ o
μπάλωσε|b ˈa l o s ˌe
μπάτσο|b ˈa ts o
μπάτσους|b ˈa ts u s
μπήγοντας|b ˈi ɣ o d ˌa s
μπήκαμε|b ˈi k a m ˌe
μπήκαν|b ˈi k a n
μπήκε|b ˈi c e
μπήκες|b ˈi c e s
μπήξει|b ˈi k s i
μπήχθηκαν|b ˈi x θ i k ˌa n
μπήχθηκε|b ˈi x θ i c ˌe
μπαίνετε|b ˈe n e t ˌe
μπακάλη|b a k ˈa l i
μπακάλικο|b a k ˈa l i k ˌo
μπακάλικου|b a k ˈa l i k ˌu
μπαλάσκα|b a l ˈa s k a
μπαλωματή|b ˌa l o m a t ˈi
μπαστουνάκι|b ˌa s t u n ˈa c i
μπερδεύτηκε|b e r ð ˈe f t i c ˌe
μπερεύτηκαν|b e r ˈe f t i k ˌa n
μπερμπάντη|b e r b ˈa d i
μπερμπάντηδες|b e r b ˈa d i ð ˌe s
μπερμπάντης|b e r b ˈa d i s
μπλούζα|b l ˈu z a
μπο|b ˈo
μπορέσαμε|b o r ˈe s a m ˌe
μπορέσει|b o r ˈe s i
μπορέσεις|b o r ˈe s i s
μπορέσομε|b o r ˈe s o m ˌe
μπορεί|b o r ˈi
μπορείς|b o r ˈi s
μπορείτε|b o r ˈi t e
μπορούμε|b o r ˈu m e
μπορούν|b o r ˈu n
μπορούσα|b o r ˈu s a
μπορούσαμε|b o r ˈu s a m ˌe
μπορούσαν|b o r ˈu s a n
μπορούσε|b o r ˈu s e
μπορούσες|b o r ˈu s e s
μποτίλια|b o t ˈi ʎ a
μποτίλιας|b o t ˈi ʎ a s
μποτίλιες|b o t ˈi ʎ e s
μπουγάδας|b u ɣ ˈa ð a s
μπουν|b ˈu n
μπούμε|b ˈu m e
μπράβο|b r ˈa v o
μπράτσο|b r ˈa ts o
μπρε|b r ˈe
μπρος|b r ˈo s
μπροστά|b r o s t ˈa
μπόλικα|b ˈo l i k ˌa
μπόρεσα|b ˈo r e s ˌa
μπόρεσε|b ˈo r e s ˌe
μυαλά|m ˌi  a l ˈa
μυρωδάτα|m ˌi r o ð ˈa t a
μυστήριο|m i s t ˈi r i  ˌo
μυστικά|m ˌi s t i k ˈa
μυστική|m ˌi s t i c ˈi
μυστικούς|m ˌi s t i k ˈu s
μόλις|m ˈo l i s
μόνες|m ˈo n e s
μόνη|m ˈo n i
μόνο|m ˈo n o
μόνος|m ˈo n o s
μύλους|m ˈi l u s
μύρισε|m ˈi r i s ˌe
μύτες|m ˈi t e s
μ’|m ˈi
ν'|n ˈi
νά|n ˈa
νάνος|n ˈa n o s
νάρχισε|n ˈa r ç i s ˌe
νέα|n ˈe a
νέοι|n ˈe i
νέον|n ˈe o n
νέος|n ˈe o s
νέου|n ˈe u
νέους|n ˈe u s
νήμα|n ˈi m a
νίκη|n ˈi c i
νίκησαν|n ˈi c i s ˌa n
νίκησε|n ˈi c i s ˌe
να|n ˈa
ναι|n ˈe
ναυτικό|n ˌa f t i k ˈo
ναύαρχος|n ˈa v a r x ˌo s
ναύσταθμο|n ˈa f s t a θ m ˌo
ναύσταθμος|n ˈa f s t a θ m ˌo s
ναύτες|n ˈa f t e s
ναύτη|n ˈa f t i
ναύτης|n ˈa f t i s
νε|n ˈe
νερά|n e r ˈa
νεραϊδούλα|n ˌe r aɪ ð ˈu l a
νερού|n e r ˈu
νεται|n ˈe t e
νευρικά|n ˌe v r i k ˈa
νευρικό|n ˌe v r i k ˈo
νευρικός|n ˌe v r i k ˈo s
νεόφτιαστα|n e ˈo f t i  ˌa s t a
νεύρα|n ˈe v r a
νησιώτικο|n i s j ˈo t i k ˌo
νηστείας|n i s t ˈi  a s
νιάτα|ɲ ˈa t a
νια|ɲ ˈa
νικημένος|n ˌi c i m ˈe n o s
νικητή|n ˌi c i t ˈi
νιώθομε|ɲ ˈo θ o m ˌe
νιώθω|ɲ ˈo θ o
νιώσει|ɲ ˈo s i
νιώσεις|ɲ ˈo s i s
νιώσουν|ɲ ˈo s u n
νοιάστηκε|ɲ ˈa s t i c ˌe
νοικοκυρέους|n ˌi k o c i r ˈe u s
νοικοκυρεμένα|n ˌi k o c ˌi r e m ˈe n a
νοικοκύρης|n ˌi k o c ˈi r i s
νομίζει|n o m ˈi z i
νομίζεις|n o m ˈi z i s
νομίζοντας|n o m ˈi z o d ˌa s
νος|n ˈo s
νοσηλεύτριες|n ˌo s i l ˈe f t r i  ˌe s
νοσοκομείο|n ˌo s o k o m ˈi  o
νοσοκόμος|n ˌo s o k ˈo m o s
νοστιμάδα|n ˌo s t i m ˈa ð a
νου|n ˈu
νούμερα|n ˈu m e r ˌa
ντουλάπια|d u l ˈa p ç a
ντροπιασμένος|d r ˌo p ç a s m ˈe n o s
ντυθούν|d i θ ˈu n
ντυθώ|d i θ ˈo
ντυμένο|d i m ˈe n o
ντυμένος|d i m ˈe n o s
νυσταγμένη|n ˌi s t a ɣ m ˈe n i
νυχτερινή|n ˌi x t e r i n ˈi
νυχτερινό|n ˌi x t e r i n ˈo
νυχτώσει|n i x t ˈo s i
νωρίς|n o r ˈi s
νωρίτερα|n o r ˈi t e r ˌa
νόημα|n ˈoɪ m a
νόστιμος|n ˈo s t i m ˌo s
νύφες|n ˈi f e s
νύχτα|n ˈi x t a
νύχτας|n ˈi x t a s
ξάπλωσαν|k s ˈa p l o s ˌa n
ξάφνιασμα|k s ˈa f ɲ a s m ˌa
ξέκοβε|k s ˈe k o v ˌe
ξένα|k s ˈe n a
ξένο|k s ˈe n o
ξένους|k s ˈe n u s
ξέπεσε|k s ˈe p e s ˌe
ξέπλεναν|k s ˈe p l e n ˌa n
ξέπλενε|k s ˈe p l e n ˌe
ξέραμε|k s ˈe r a m ˌe
ξέρει|k s ˈe r i
ξέρεις|k s ˈe r i s
ξέρομε|k s ˈe r o m ˌe
ξέρουν|k s ˈe r u n
ξέρω|k s ˈe r o
ξέσπασαν|k s ˈe s p a s ˌa n
ξέσπασε|k s ˈe s p a s ˌe
ξέσχισμα|k s ˈe s ç i s m ˌa
ξέφυγε|k s ˈe f i j ˌe
ξέχασα|k s ˈe x a s ˌa
ξέχασαν|k s ˈe x a s ˌa n
ξέχασε|k s ˈe x a s ˌe
ξέχασες|k s ˈe x a s ˌe s
ξήλωσε|k s ˈi l o s ˌe
ξα|k s ˈa
ξαμαρτία|k s ˌa m a r t ˈi  a
ξανάβγαιναν|k s a n ˈa v j e n ˌa n
ξανάβλεπα|k s a n ˈa v l e p ˌa
ξανάδεσαν|k s a n ˈa ð e s ˌa n
ξανάδεσε|k s a n ˈa ð e s ˌe
ξανάμπηξε|k s a n ˈa b i k s ˌe
ξανάπεσε|k s a n ˈa p e s ˌe
ξανάπιασε|k s a n ˈa p ç a s ˌe
ξανάρθαν|k s a n ˈa r θ a n
ξανάρθει|k s a n ˈa r θ i
ξανάρθουν|k s a n ˈa r θ u n
ξανάρχιζε|k s a n ˈa r ç i z ˌe
ξανάρχισε|k s a n ˈa r ç i s ˌe
ξανάσπειραν|k s a n ˈa s p i r ˌa n
ξαναβλαστάνουν|k s ˌa n a v l a s t ˈa n u n
ξαναβρεί|k s ˌa n a v r ˈi
ξαναγέμιζαν|k s ˌa n a j ˈe m i z ˌa n
ξαναγίνει|k s ˌa n a j ˈi n i
ξαναγίνουν|k s ˌa n a j ˈi n u n
ξαναγυρίσουν|k s ˌa n a j i r ˈi s u n
ξαναγύριζε|k s ˌa n a j ˈi r i z ˌe
ξαναδίπλωσε|k s ˌa n a ð ˈi p l o s ˌe
ξαναδεμένες|k s ˌa n a ð e m ˈe n e s
ξαναδιαλέγοντας|k s ˌa n a ð ˌi  a l ˈe ɣ o d ˌa s
ξαναδώσω|k s ˌa n a ð ˈo s o
ξαναείδαν|k s ˌa n a ˈi ð a n
ξαναείδες|k s ˌa n a ˈi ð e s
ξαναθάρρεψε|k s ˌa n a θ ˈa r e p s ˌe
ξαναθυμούνταν|k s ˌa n a θ i m ˈu d a n
ξανακάθησε|k s ˌa n a k ˈa θ i s ˌe
ξανακατεβάσει|k s ˌa n a k ˌa t e v ˈa s i
ξαναμάθει|k s ˌa n a m ˈa θ i
ξαναμαζεύουνταν|k s ˌa n a m a z ˈe v u d ˌa n
ξαναμαλώσουν|k s ˌa n a m a l ˈo s u n
ξαναμοιράσεις|k s ˌa n a m i r ˈa s i s
ξανανάψει|k s ˌa n a n ˈa p s i
ξανανέβηκε|k s ˌa n a n ˈe v i c ˌe
ξανανιώσει|k s ˌa n a ɲ ˈo s i
ξανανταμώσεις|k s ˌa n a d a m ˈo s i s
ξαναπέρασε|k s ˌa n a p ˈe r a s ˌe
ξαναπήρε|k s ˌa n a p ˈi r e
ξαναπαρουσιαστείς|k s ˌa n a p ˌa r u s j a s t ˈi s
ξαναπεί|k s ˌa n a p ˈi
ξαναπεράσουν|k s ˌa n a p e r ˈa s u n
ξαναπερνούσα|k s ˌa n a p e r n ˈu s a
ξαναπερνώντας|k s ˌa n a p e r n ˈo d a s
ξαναπιαστούν|k s ˌa n a p ç a s t ˈu n
ξαναπλησίασε|k s ˌa n a p l i s ˈi  a s ˌe
ξαναρχίσει|k s ˌa n a r ç ˈi s i
ξανασπούσε|k s ˌa n a s p ˈu s e
ξαναφέρνει|k s ˌa n a f ˈe r n i
ξαναφτιάξεις|k s ˌa n a f t i  ˈa k s i s
ξαναφτιάσεις|k s ˌa n a f t i  ˈa s i s
ξαναφτιάσουμε|k s ˌa n a f t i  ˈa s u m ˌe
ξαναφύτεψαν|k s ˌa n a f ˈi t e p s ˌa n
ξαναφώναξε|k s ˌa n a f ˈo n a k s ˌe
ξαναχτίσεις|k s ˌa n a x t ˈi s i s
ξαναχτίσω|k s ˌa n a x t ˈi s o
ξαναχτιστεί|k s ˌa n a x t i s t ˈi
ξαναχτύπησε|k s ˌa n a x t ˈi p i s ˌe
ξανθή|k s a n θ ˈi
ξαπλωθεί|k s ˌa p l o θ ˈi
ξαπλωμένη|k s ˌa p l o m ˈe n i
ξαπλωμένο|k s ˌa p l o m ˈe n o
ξαπλωμένοι|k s ˌa p l o m ˈe n i
ξαπλωμένος|k s ˌa p l o m ˈe n o s
ξαπλώθηκαν|k s a p l ˈo θ i k ˌa n
ξαπλώθηκε|k s a p l ˈo θ i c ˌe
ξαφνίστηκε|k s a f n ˈi s t i c ˌe
ξαφνισμένα|k s ˌa f n i s m ˈe n a
ξαφνισμένο|k s ˌa f n i s m ˈe n o
ξαφνισμένος|k s ˌa f n i s m ˈe n o s
ξε|k s ˈe
ξεγυαλισμένο|k s ˌe j a l i s m ˈe n o
ξεδίπλωσε|k s e ð ˈi p l o s ˌe
ξεθωριασμένες|k s ˌe θ o r ˌi  a s m ˈe n e s
ξεθωριασμένο|k s ˌe θ o r ˌi  a s m ˈe n o
ξεκάρδισμα|k s e k ˈa r ð i s m ˌa
ξεκίνησαν|k s e c ˈi n i s ˌa n
ξεκίνησε|k s e c ˈi n i s ˌe
ξεκαβαλίκεψε|k s ˌe k a v a l ˈi c e p s ˌe
ξεκαρδίστηκαν|k s ˌe k a r ð ˈi s t i k ˌa n
ξεκαρδίστηκε|k s ˌe k a r ð ˈi s t i c ˌe
ξεκαρδισμένοι|k s ˌe k a r ð i s m ˈe n i
ξεκαρδισμένος|k s ˌe k a r ð i s m ˈe n o s
ξεκινούν|k s ˌe c i n ˈu n
ξεκινούσε|k s ˌe c i n ˈu s e
ξεκουράσου|k s ˌe k u r ˈa s u
ξεκουραστεί|k s ˌe k u r a s t ˈi
ξεκουραστείτε|k s ˌe k u r a s t ˈi t e
ξεκουραστούμε|k s ˌe k u r a s t ˈu m e
ξεκουφαίνεις|k s ˌe k u f ˈe n i s
ξεκούφαναν|k s e k ˈu f a n ˌa n
ξελαφρωμένοι|k s ˌe l a f r o m ˈe n i
ξελαχανιάσει|k s ˌe l a x a ɲ ˈa s i
ξεμάθει|k s e m ˈa θ i
ξεμάθετε|k s e m ˈa θ e t ˌe
ξεμπαρκάρησε|k s ˌe b a r k ˈa r i s ˌe
ξεμπαρκάρομε|k s ˌe b a r k ˈa r o m ˌe
ξεμπερδεύτηκε|k s ˌe b e r ð ˈe f t i c ˌe
ξεμύτιζαν|k s e m ˈi t i z ˌa n
ξενητεμένοι|k s ˌe n i t e m ˈe n i
ξενοδοχείο|k s ˌe n o ð o ç ˈi  o
ξεπετάχθηκε|k s ˌe p e t ˈa x θ i c ˌe
ξεπληρώσετε|k s ˌe p l i r ˈo s e t ˌe
ξεπληρώσω|k s ˌe p l i r ˈo s o
ξεπλυθεί|k s ˌe p l i θ ˈi
ξεπλύνω|k s e p l ˈi n o
ξεπορτίζει|k s ˌe p o r t ˈi z i
ξεπορτίζεις|k s ˌe p o r t ˈi z i s
ξεπούλησε|k s e p ˈu l i s ˌe
ξεπρόβαλαν|k s e p r ˈo v a l ˌa n
ξεπόρτισαν|k s e p ˈo r t i s ˌa n
ξεροψημένο|k s ˌe r o p s i m ˈe n o
ξερό|k s e r ˈo
ξερός|k s e r ˈo s
ξεσκέπασε|k s e s c ˈe p a s ˌe
ξεσπάθωσε|k s e s p ˈa θ o s ˌe
ξεσπάσουν|k s e s p ˈa s u n
ξεσπαθώνοντας|k s ˌe s p a θ ˈo n o d ˌa s
ξεστομίσει|k s ˌe s t o m ˈi s i
ξετραχηλωμένες|k s ˌe t r a ç ˌi l o m ˈe n e s
ξετρελαμένοι|k s ˌe t r e l a m ˈe n i
ξετρύπωσε|k s e t r ˈi p o s ˌe
ξετύλιξε|k s e t ˈi l i k s ˌe
ξεφαντώματα|k s ˌe f a d ˈo m a t ˌa
ξεφορτώθηκα|k s ˌe f o r t ˈo θ i k ˌa
ξεφορτώθηκες|k s ˌe f o r t ˈo θ i c ˌe s
ξεφωνίζει|k s ˌe f o n ˈi z i
ξεφωνητά|k s ˌe f o n i t ˈa
ξεφόρτωσε|k s e f ˈo r t o s ˌe
ξεφύγει|k s e f ˈi j i
ξεφύγω|k s e f ˈi ɣ o
ξεφώλιαζε|k s e f ˈo ʎ a z ˌe
ξεφώνιζαν|k s e f ˈo n i z ˌa n
ξεφώνιζε|k s e f ˈo n i z ˌe
ξεφώνισε|k s e f ˈo n i s ˌe
ξεχάσει|k s e x ˈa s i
ξεχάσεις|k s e x ˈa s i s
ξεχάσομε|k s e x ˈa s o m ˌe
ξεχάσω|k s e x ˈa s o
ξεχασμένα|k s ˌe x a s m ˈe n a
ξεχειλούσαν|k s ˌe ç i l ˈu s a n
ξεχνά|k s e x n ˈa
ξεχνάς|k s e x n ˈa s
ξεχνώντας|k s e x n ˈo d a s
ξεχρυσωμένο|k s ˌe x r i s o m ˈe n o
ξεχωρίσει|k s ˌe x o r ˈi s i
ξεχώριζε|k s e x ˈo r i z ˌe
ξεχώρισε|k s e x ˈo r i s ˌe
ξεψυχήσει|k s ˌe p s i ç ˈi s i
ξεψύχησε|k s e p s ˈi ç i s ˌe
ξηρά|k s i r ˈa
ξοδευτούν|k s ˌo ð e f t ˈu n
ξοδιάσεις|k s ˌo ð i  ˈa s i s
ξυλαράκια|k s ˌi l a r ˈa c a
ξυλοκοπος|k s ˌi l o k ˈo p o s
ξυλοκόποι|k s ˌi l o k ˈo p i
ξυλοκόπος|k s ˌi l o k ˈo p o s
ξυλοπινάκα|k s ˌi l o p i n ˈa k a
ξυνήθρα|k s i n ˈi θ r a
ξυπνά|k s i p n ˈa
ξυπνήσει|k s i p n ˈi s i
ξυπνήσω|k s i p n ˈi s o
ξυπνητή|k s ˌi p n i t ˈi
ξυπνητήρι|k s ˌi p n i t ˈi r i
ξυπνητός|k s ˌi p n i t ˈo s
ξυπνούσε|k s i p n ˈu s e
ξυπνούσες|k s i p n ˈu s e s
ξύλινα|k s ˈi l i n ˌa
ξύλινη|k s ˈi l i n ˌi
ξύλινο|k s ˈi l i n ˌo
ξύπνα|k s ˈi p n a
ξύπνησαν|k s ˈi p n i s ˌa n
ξύπνησε|k s ˈi p n i s ˌe
ξύπνησες|k s ˈi p n i s ˌe s
ο|ˈo m i k r ˌo n
ογδόου|o ɣ ð ˈo u
οδήγησαν|o ð ˈi j i s ˌa n
οδήγησε|o ð ˈi j i s ˌe
οδηγήσει|ˌo ð i j ˈi s i
οδηγήσεις|ˌo ð i j ˈi s i s
οδηγήσουν|ˌo ð i j ˈi s u n
οδηγήσω|ˌo ð i j ˈi s o
οδηγίες|ˌo ð i j ˈi  e s
οδηγεί|ˌo ð i j ˈi
οδηγούσε|ˌo ð i ɣ ˈu s e
οδηγός|ˌo ð i ɣ ˈo s
οι|ˈi
οικολογικά|ˌi k o l ˌo j i k ˈa
ολ'|ˈo l
ολοένα|ˌo l o ˈe n a
ολοκληρωμένο|ˌo l o k l ˌi r o m ˈe n o
ολομόναχες|ˌo l o m ˈo n a ç ˌe s
ολονών|ˌo l o n ˈo n
ολοπάστρικα|ˌo l o p ˈa s t r i k ˌa
ολοστρόγγυλος|ˌo l o s t r ˈo ŋ ɡ i l ˌo s
ολωνών|ˌo l o n ˈo n
ολόγυρα|o l ˈo j i r ˌa
ολόκληρο|o l ˈo k l i r ˌo
ολόκληρον|o l ˈo k l i r ˌo n
ολόκληρος|o l ˈo k l i r ˌo s
ολόκληρου|o l ˈo k l i r ˌu
ολόρθα|o l ˈo r θ a
ολότελα|o l ˈo t e l ˌa
ολόχρυση|o l ˈo x r i s ˌi
ομιλία|ˌo m i l ˈi  a
ομιλίες|ˌo m i l ˈi  e s
ομοιότητα|ˌo m i  ˈo t i t ˌa
ομολογήσει|ˌo m o l o j ˈi s i
ομορφιά|ˌo m o r f i  ˈa
ομορφιές|ˌo m o r f i  ˈe s
ον|ˈo n
ονειρεύεσαι|ˌo n i r ˈe v e s ˌe
ονειρεύομαι|ˌo n i r ˈe v o m ˌe
ονειροφορτωμένα|ˌo n i r ˌo f o r t o m ˈe n a
ονόματα|o n ˈo m a t ˌa
οπλίσεις|o p l ˈi s i s
οπλίσομε|o p l ˈi s o m ˌe
οπλίσουμε|o p l ˈi s u m ˌe
οποίας|o p ˈi  a s
οποίο|o p ˈi  o
οπου|ˈo p u
οπωρικά|ˌo p o r i k ˈa
οπόταν|o p ˈo t a n
ορίζοντα|o r ˈi z o d ˌa
ορίσατε|o r ˈi s a t ˌe
οργισμένος|ˌo r j i s m ˈe n o s
ορεκτικοί|ˌo r e k t i c ˈi
ορεκτικό|ˌo r e k t i k ˈo
ορεκτικότατη|ˌo r e k t i k ˈo t a t ˌi
ορθάνοιχτα|o r θ ˈa n i x t ˌa
ορθογραφίας|ˌo r θ o ɣ r a f ˈi  a s
ορκίζομαι|o r c ˈi z o m ˌe
ορμή|o r m ˈi
ορνιθαριά|ˌo r n i θ ˌa r i  ˈa
ορνιθαριό|ˌo r n i θ ˌa r i  ˈo
ορούς|o r ˈu s
ορτσωμένα|ˌo r ts o m ˈe n a
οταν|ˈo t a n
ου|ˈu
ουνά|u n ˈa
ουρά|u r ˈa
ουρανό|ˌu r a n ˈo
ουτ'|ˈu t
ούτ'|ˈu t
ούτε|ˈu t e
πάγει|p ˈa j i
πάγκο|p ˈa ŋ ɡ o
πάγκου|p ˈa ŋ ɡ u
πάγω|p ˈa ɣ o
πάγωνε|p ˈa ɣ o n ˌe
πάει|p ˈa i
πάλευε|p ˈa l e v ˌe
πάλη|p ˈa l i
πάλι|p ˈa l i
πάμε|p ˈa m e
πάνε|p ˈa n e
πάντα|p ˈa d a
πάνω|p ˈa n o
πάπια|p ˈa p ç a
πάπιας|p ˈa p ç a s
πάπιες|p ˈa p ç e s
πάπλωμα|p ˈa p l o m ˌa
πάρε|p ˈa r e
πάρει|p ˈa r i
πάρεις|p ˈa r i s
πάρομε|p ˈa r o m ˌe
πάρουν|p ˈa r u n
πάρτε|p ˈa r t e
πάρω|p ˈa r o
πάτε|p ˈa t e
πάτησε|p ˈa t i s ˌe
πάτο|p ˈa t o
πάτωμα|p ˈa t o m ˌa
πέδιλα|p ˈe ð i l ˌa
πέθαναν|p ˈe θ a n ˌa n
πέντε|p ˈe d e
πέρα|p ˈe r a
πέρασαν|p ˈe r a s ˌa n
πέρασε|p ˈe r a s ˌe
πέρασμά|p ˈe r a s m ˈa
πέρναγε|p ˈe r n a j ˌe
πέσει|p ˈe s i
πέσουν|p ˈe s u n
πέσω|p ˈe s o
πέταξαν|p ˈe t a k s ˌa n
πέταξε|p ˈe t a k s ˌe
πέτρα|p ˈe t r a
πέτρες|p ˈe t r e s
πέτρινες|p ˈe t r i n ˌe s
πέτρινη|p ˈe t r i n ˌi
πέτρινοι|p ˈe t r i n ˌi
πέτρινους|p ˈe t r i n ˌu s
πέτσινη|p ˈe ts i n ˌi
πέτυχε|p ˈe t i ç ˌe
πέφτει|p ˈe f t i
πέφτοντας|p ˈe f t o d ˌa s
πήγα|p ˈi ɣ a
πήγαινα|p ˈi j e n ˌa
πήγαιναν|p ˈi j e n ˌa n
πήγαινε|p ˈi j e n ˌe
πήγαινες|p ˈi j e n ˌe s
πήγαμε|p ˈi ɣ a m ˌe
πήγαν|p ˈi ɣ a n
πήγε|p ˈi j e
πήγες|p ˈi j e s
πήδα|p ˈi ð a
πήδημα|p ˈi ð i m ˌa
πήδηξε|p ˈi ð i k s ˌe
πήδο|p ˈi ð o
πήρα|p ˈi r a
πήραν|p ˈi r a n
πήρανε|p ˈi r a n ˌe
πήρε|p ˈi r e
πήρες|p ˈi r e s
πίδες|p ˈi ð e s
πίκρα|p ˈi k r a
πίκρες|p ˈi k r e s
πίνακα|p ˈi n a k ˌa
πίνουν|p ˈi n u n
πίστευαν|p ˈi s t e v ˌa n
πίστευε|p ˈi s t e v ˌe
πίτες|p ˈi t e s
πα|p ˈa
παίζοντας|p ˈe z o d ˌa s
παίρναν|p ˈe r n a n
παίρνεις|p ˈe r n i s
παίρνοντας|p ˈe r n o d ˌa s
παίρνουν|p ˈe r n u n
παγούρι|p a ɣ ˈu r i
παγώσει|p a ɣ ˈo s i
παιδαγωγικό|p ˌe ð a ɣ ˌo j i k ˈo
παιδιού|p ˌe ð i  ˈu
παιδούλα|p e ð ˈu l a
παινιέσαι|p e ɲ ˈe s e
παιχνίδι|p e x n ˈi ð i
παιχνίδια|p e x n ˈi ð j a
παλάβω|p a l ˈa v o
παλάβως|p a l ˈa v o s
παλάμη|p a l ˈa m i
παλάτι|p a l ˈa t i
παλέψουν|p a l ˈe p s u n
παλαβός|p ˌa l a v ˈo s
παλατάκι|p ˌa l a t ˈa c i
παλατι|p a l ˈa t i
παλατιανοί|p ˌa l a t ˌi  a n ˈi
παλατιανοι|p ˌa l a t i  ˈa n i
παλατιανούς|p ˌa l a t ˌi  a n ˈu s
παλατιανό|p ˌa l a t ˌi  a n ˈo
παλατιανός|p ˌa l a t ˌi  a n ˈo s
παλατιού|p ˌa l a t i  ˈu
παλιάνθρωπε|p a ʎ ˈa n θ r o p ˌe
παλικάρι|p ˌa l i k ˈa r i
παλικάρια|p ˌa l i k ˈa r i  ˌa
παλικαράς|p ˌa l i k a r ˈa s
παλιοσέντουκα|p ˌa ʎ o s ˈe d u k ˌa
παλιοφελούκες|p ˌa ʎ o f e l ˈu c e s
παλιωμένη|p ˌa ʎ o m ˈe n i
παλιωμένο|p ˌa ʎ o m ˈe n o
παλιό|p a ʎ ˈo
παλιόπαιδο|p a ʎ ˈo p e ð ˌo
παλιόσπιτο|p a ʎ ˈo s p i t ˌo
παλιόχαρτα|p a ʎ ˈo x a r t ˌa
παμπάλαιο|p a b ˈa l e ˌo
παν|p ˈa n
πανέρι|p a n ˈe r i
πανέρια|p a n ˈe r i  ˌa
πανί|p a n ˈi
πανεριού|p ˌa n e r i  ˈu
πανεροφορτωμένοι|p ˌa n e r ˌo f o r t o m ˈe n i
πανιά|p a ɲ ˈa
πανικος|p a n ˈi k o s
πανικό|p ˌa n i k ˈo
πανικός|p ˌa n i k ˈo s
πανουργάκηδων|p ˌa n u r ɣ ˈa c i ð ˌo n
πανουργάκο|p ˌa n u r ɣ ˈa k o
πανουργάκος|p ˌa n u r ɣ ˈa k o s
πανουργάκου|p ˌa n u r ɣ ˈa k u
παντελεήμων|p ˌa d e l e ˈi m o n
παντογνώστης|p ˌa d o ɣ n ˈo s t i s
παντοτινή|p ˌa d o t i n ˈi
παντρευθείς|p ˌa d r e f θ ˈi s
πανωλεθρία|p ˌa n o l e θ r ˈi  a
παξιμάδια|p ˌa k s i m ˈa ð j a
παπουτσάκια|p ˌa p u ts ˈa c a
παπούτσι|p a p ˈu ts i
παππού|p a p ˈu
παππούς|p a p ˈu s
παρά|p a r ˈa
παράβγαιναν|p a r ˈa v j e n ˌa n
παράγγειλε|p a r ˈa ŋ ɡ i l ˌe
παράγγελνε|p a r ˈa ŋ ɡ e l n ˌe
παράδειγμα|p a r ˈa ð i ɣ m ˌa
παράδες|p a r ˈa ð e s
παράθυρα|p a r ˈa θ i r ˌa
παράθυρο|p a r ˈa θ i r ˌo
παράμερα|p a r ˈa m e r ˌa
παράνομη|p a r ˈa n o m ˌi
παράξενες|p a r ˈa k s e n ˌe s
παράξενο|p a r ˈa k s e n ˌo
παράξενος|p a r ˈa k s e n ˌo s
παράπονα|p a r ˈa p o n ˌa
παράπονο|p a r ˈa p o n ˌo
παράσημο|p a r ˈa s i m ˌo
παράτησα|p a r ˈa t i s ˌa
παράτησαν|p a r ˈa t i s ˌa n
παράτησε|p a r ˈa t i s ˌe
παρέδινε|p a r ˈe ð i n ˌe
παρέδωσε|p a r ˈe ð o s ˌe
παρέσυρε|p a r ˈe s i r ˌe
παρέσυρες|p a r ˈe s i r ˌe s
παρήγγειλε|p a r ˈi ŋ ɡ i l ˌe
παραγγέλνει|p ˌa r a ŋ ɡ ˈe l n i
παραγγείλει|p ˌa r a ŋ ɡ ˈi l i
παραγγελία|p ˌa r a ŋ ɡ e l ˈi  a
παραγγελίες|p ˌa r a ŋ ɡ e l ˈi  e s
παραγιοί|p ˌa r a j ˈi
παραγιούς|p ˌa r a j ˈu s
παραγιός|p ˌa r a j ˈo s
παραγιών|p ˌa r a j ˈo n
παραγωγής|p ˌa r a ɣ o j ˈi s
παραδέχουνταν|p ˌa r a ð ˈe x u d ˌa n
παραδίνει|p ˌa r a ð ˈi n i
παραδίνουνταν|p ˌa r a ð ˈi n u d ˌa n
παραδείγματα|p ˌa r a ð ˈi ɣ m a t ˌa
παραδομένη|p ˌa r a ð o m ˈe n i
παραδώσει|p ˌa r a ð ˈo s i
παραζαλισμένοι|p ˌa r a z ˌa l i s m ˈe n i
παραζαλισμένος|p ˌa r a z ˌa l i s m ˈe n o s
παραθύρου|p ˌa r a θ ˈi r u
παραισθήσεις|p ˌa r e s θ ˈi s i s
παραιτούνταν|p ˌa r e t ˈu d a n
παρακάλεσε|p ˌa r a k ˈa l e s ˌe
παρακάτω|p ˌa r a k ˈa t o
παρακαταθήκη|p ˌa r a k ˌa t a θ ˈi c i
παρακολουθήσει|p ˌa r a k ˌo l u θ ˈi s i
παρακολούθησε|p ˌa r a k o l ˈu θ i s ˌe
παρακόρες|p ˌa r a k ˈo r e s
παρακόρη|p ˌa r a k ˈo r i
παραμάγειρα|p ˌa r a m ˈa j i r ˌa
παραμάγειρας|p ˌa r a m ˈa j i r ˌa s
παραμέρισε|p ˌa r a m ˈe r i s ˌe
παραμερίζοντας|p ˌa r a m e r ˈi z o d ˌa s
παραμερίσει|p ˌa r a m e r ˈi s i
παραμερίσετε|p ˌa r a m e r ˈi s e t ˌe
παραμονή|p ˌa r a m o n ˈi
παραμύθια|p ˌa r a m ˈi θ i  ˌa
παραξενεύθηκα|p ˌa r a k s e n ˈe f θ i k ˌa
παραξενεύθηκαν|p ˌa r a k s e n ˈe f θ i k ˌa n
παραξενεύθηκε|p ˌa r a k s e n ˈe f θ i c ˌe
παραξενιά|p ˌa r a k s e ɲ ˈa
παραπάτησε|p ˌa r a p ˈa t i s ˌe
παραπεμπτικό|p ˌa r a p ˌe b t i k ˈo
παραπονέθηκε|p ˌa r a p o n ˈe θ i c ˌe
παραπονιάρικα|p ˌa r a p o ɲ ˈa r i k ˌa
παραπόταμα|p ˌa r a p ˈo t a m ˌa
παρασύρθηκε|p ˌa r a s ˈi r θ i c ˌe
παρατάτε|p ˌa r a t ˈa t e
παρατήρησαν|p ˌa r a t ˈi r i s ˌa n
παρατήρησε|p ˌa r a t ˈi r i s ˌe
παρατήσεις|p ˌa r a t ˈi s i s
παρατημένα|p ˌa r a t i m ˈe n a
παρατημένοι|p ˌa r a t i m ˈe n i
παρατηρούσε|p ˌa r a t i r ˈu s e
παρατηρώντας|p ˌa r a t i r ˈo d a s
παρατούσαν|p ˌa r a t ˈu s a n
παρατώντας|p ˌa r a t ˈo d a s
παραφέντη|p ˌa r a f ˈe d i
παραφέντης|p ˌa r a f ˈe d i s
παραχοντρύνει|p ˌa r a x o d r ˈi n i
παρδαλής|p ˌa r ð a l ˈi s
παρηγορήσει|p ˌa r i ɣ o r ˈi s i
παρηγορήσεις|p ˌa r i ɣ o r ˈi s i s
παρηγόρησε|p ˌa r i ɣ ˈo r i s ˌe
παρουσίασε|p ˌa r u s ˈi  a s ˌe
παρουσιάζεται|p ˌa r u s j ˈa z e t ˌe
παρουσιάστηκε|p ˌa r u s j ˈa s t i c ˌe
παρουσιαστείς|p ˌa r u s j a s t ˈi s
παρούσας|p a r ˈu s a s
παρων|p ˈa r o n
παρόμοια|p a r ˈo m i  ˌa
παρόντες|p a r ˈo d e s
παρών|p a r ˈo n
παρώνφώναξε|p a r ˈo n f ˈo n a k s ˌe
πας|p ˈa s
παστίτσιο|p a s t ˈi ts i  ˌo
παστρευθεί|p ˌa s t r e f θ ˈi
παστρικά|p ˌa s t r i k ˈa
πατά|p a t ˈa
πατέρας|p a t ˈe r a s
πατήσει|p a t ˈi s i
πατήτρες|p a t ˈi t r e s
πατίνια|p a t ˈi ɲ a
πατούσαμε|p a t ˈu s a m ˌe
πατρίδας|p a t r ˈi ð a s
πατρικό|p ˌa t r i k ˈo
πατριώτες|p ˌa t r i  ˈo t e s
πατριώτη|p ˌa t r i  ˈo t i
πατριώτης|p ˌa t r i  ˈo t i s
πατρογονική|p ˌa t r o ɣ ˌo n i c ˈi
παχουλά|p ˌa x u l ˈa
παχύ|p a ç ˈi
παύσετε|p ˈa f s e t ˌe
παύσομε|p ˈa f s o m ˌe
παύσουν|p ˈa f s u n
πε|p ˈe
πείθουνταν|p ˈi θ u d ˌa n
πείνα|p ˈi n a
πείνασαν|p ˈi n a s ˌa n
πείσει|p ˈi s i
πείσματα|p ˈi s m a t ˌa
πείσω|p ˈi s o
πείτε|p ˈi t e
πεδιάδα|p ˌe ð i  ˈa ð a
πεδιάδας|p ˌe ð i  ˈa ð a s
πεδιάδες|p ˌe ð i  ˈa ð e s
πεζή|p e z ˈi
πεζούλι|p e z ˈu l i
πεθάνεις|p e θ ˈa n i s
πεθάνομε|p e θ ˈa n o m ˌe
πεθάνω|p e θ ˈa n o
πεθαίνουν|p e θ ˈe n u n
πεθαίνω|p e θ ˈe n o
πεθαμένος|p ˌe θ a m ˈe n o s
πεθαμένου|p ˌe θ a m ˈe n u
πεθαμένους|p ˌe θ a m ˈe n u s
πει|p ˈi
πεινάσει|p i n ˈa s i
πεινασμένοι|p ˌi n a s m ˈe n i
πεινασμένους|p ˌi n a s m ˈe n u s
πεινούν|p i n ˈu n
πεινούσε|p i n ˈu s e
πεις|p ˈi s
πελάτη|p e l ˈa t i
πελέκα|p e l ˈe k a
πελεκά|p ˌe l e k ˈa
πελεκάς|p ˌe l e k ˈa s
πελεκηθούν|p ˌe l e c i θ ˈu n
πενηνταπεντάρα|p ˌe n i d ˌa p e d ˈa r a
πεποίθηση|p e p ˈi θ i s ˌi
περάσεις|p e r ˈa s i s
περάσομε|p e r ˈa s o m ˌe
περάσουν|p e r ˈa s u n
περήφανα|p e r ˈi f a n ˌa
περίγραψε|p e r ˈi ɣ r a p s ˌe
περίεργα|p e r ˈi  e r ɣ ˌa
περίεργη|p e r ˈi  e r j ˌi
περίεργο|p e r ˈi  e r ɣ ˌo
περίεργος|p e r ˈi  e r ɣ ˌo s
περίζωσαν|p e r ˈi z o s ˌa n
περίλυπη|p e r ˈi l i p ˌi
περίμενα|p e r ˈi m e n ˌa
περίμεναν|p e r ˈi m e n ˌa n
περίμενε|p e r ˈi m e n ˌe
περίμενες|p e r ˈi m e n ˌe s
περίπατο|p e r ˈi p a t ˌo
περίσσευαν|p e r ˈi s s e v ˌa n
περίσταση|p e r ˈi s t a s ˌi
περίφημα|p e r ˈi f i m ˌa
περίφημη|p e r ˈi f i m ˌi
περασμένη|p ˌe r a s m ˈe n i
περασμένο|p ˌe r a s m ˈe n o
περγαμηνή|p ˌe r ɣ a m i n ˈi
περιέργεια|p ˌe r i  ˈe r j a
περιέργως|p ˌe r i  ˈe r ɣ o s
περιβολάκι|p ˌe r i v o l ˈa c i
περιβολάκια|p ˌe r i v o l ˈa c a
περιβόλι|p ˌe r i v ˈo l i
περιβόλια|p ˌe r i v ˈo ʎ a
περιδιάβαζε|p ˌe r i ð i  ˈa v a z ˌe
περιμένει|p ˌe r i m ˈe n i
περιμένεις|p ˌe r i m ˈe n i s
περιμένετε|p ˌe r i m ˈe n e t ˌe
περιμένομε|p ˌe r i m ˈe n o m ˌe
περιμένοντας|p ˌe r i m ˈe n o d ˌa s
περιορίζουνταν|p ˌe r i  o r ˈi z u d ˌa n
περιουσία|p ˌe r i  u s ˈi  a
περιπτώσεις|p ˌe r i p t ˈo s i s
περισσευούμενα|p ˌe r i s s e v ˈu m e n ˌa
περισσότερα|p ˌe r i s s ˈo t e r ˌa
περισσότερη|p ˌe r i s s ˈo t e r ˌi
περισσότερο|p ˌe r i s s ˈo t e r ˌo
περισσότερους|p ˌe r i s s ˈo t e r ˌu s
περιτριγυρισμένα|p ˌe r i t r ˌi j i r i s m ˈe n a
περιτριγύριζαν|p ˌe r i t r i j ˈi r i z ˌa n
περιττά|p ˌe r i t ˈa
περιττό|p ˌe r i t ˈo
περιφερείας|p ˌe r i f e r ˈi  a s
περιφράσεις|p ˌe r i f r ˈa s i s
περιφρονείς|p ˌe r i f r o n ˈi s
περιφρονητικά|p ˌe r i f r ˌo n i t i k ˈa
περιφρόνηση|p ˌe r i f r ˈo n i s ˌi
περνούμε|p e r n ˈu m e
περνούσα|p e r n ˈu s a
περνούσαν|p e r n ˈu s a n
περνούσε|p e r n ˈu s e
περνούσες|p e r n ˈu s e s
περνώντας|p e r n ˈo d a s
περπάτημα|p e r p ˈa t i m ˌa
περπάτησαν|p e r p ˈa t i s ˌa n
περπατά|p ˌe r p a t ˈa
περπατάτε|p ˌe r p a t ˈa t e
περπατησιές|p ˌe r p a t i s j ˈe s
περπατούν|p ˌe r p a t ˈu n
περπατούσαν|p ˌe r p a t ˈu s a n
περπατούσε|p ˌe r p a t ˈu s e
περπατώντας|p ˌe r p a t ˈo d a s
πες|p ˈe s
πεσμένες|p e s m ˈe n e s
πεσμένο|p e s m ˈe n o
πεσμένοι|p e s m ˈe n i
πεσμένους|p e s m ˈe n u s
πετάξου|p e t ˈa k s u
πετάχθηκε|p e t ˈa x θ i c ˌe
πεταλούδες|p ˌe t a l ˈu ð e s
πεταμένα|p ˌe t a m ˈe n a
πεταχτά|p ˌe t a x t ˈa
πετούσαν|p e t ˈu s a n
πετούσε|p e t ˈu s e
πετράδια|p e t r ˈa ð j a
πετριά|p ˌe t r i  ˈa
πεύκο|p ˈe f k o
πηγάδι|p i ɣ ˈa ð i
πηγάδια|p i ɣ ˈa ð j a
πηγαίναμε|p i j ˈe n a m ˌe
πηγαίνεις|p i j ˈe n i s
πηγαίνετε|p i j ˈe n e t ˌe
πηγαίνομε|p i j ˈe n o m ˌe
πηγαίνοντας|p i j ˈe n o d ˌa s
πηγαίνουν|p i j ˈe n u n
πηγαίνω|p i j ˈe n o
πηγαινοέρχεται|p ˌi j e n o ˈe r ç e t ˌe
πηγαινοέρχονται|p ˌi j e n o ˈe r x o d ˌe
πηδήξουν|p i ð ˈi k s u n
πηδούσαν|p i ð ˈu s a n
πηδώντας|p i ð ˈo d a s
πηλάλα|p i l ˈa l a
πηλαλητό|p ˌi l a l i t ˈo
πηρούνι|p i r ˈu n i
πιάνει|p ç ˈa n i
πιάνοντας|p ç ˈa n o d ˌa s
πιάσε|p ç ˈa s e
πιάσει|p ç ˈa s i
πιάσομε|p ç ˈa s o m ˌe
πιάσουν|p ç ˈa s u n
πιάστε|p ç ˈa s t e
πιάτα|p ç ˈa t a
πιάτο|p ç ˈa t o
πια|p ç ˈa
πιαστήκαμε|p ç a s t ˈi k a m ˌe
πιατέλα|p ç a t ˈe l a
πικρά|p i k r ˈa
πικρό|p i k r ˈo
πικρόχολη|p i k r ˈo x o l ˌi
πικρόχολης|p i k r ˈo x o l ˌi s
πιλαλούσε|p ˌi l a l ˈu s e
πιο|p ç ˈo
πιουν|p ç ˈu n
πιρούνι|p i r ˈu n i
πισθάγκωνα|p i s θ ˈa ŋ ɡ o n ˌa
πιστέψεις|p i s t ˈe p s i s
πιστέψετε|p i s t ˈe p s e t ˌe
πιστέψουν|p i s t ˈe p s u n
πιστέψω|p i s t ˈe p s o
πιστεύουν|p i s t ˈe v u n
πιστοποίηση|p ˌi s t o p ˈi  i s ˌi
πιστοποιημένα|p ˌi s t o p ˌi  i m ˈe n a
πιστός|p i s t ˈo s
πιτσιλώντας|p ˌi ts i l ˈo d a s
πιωμένο|p ç o m ˈe n o
πιότερο|p ç ˈo t e r ˌo
πλάγι|p l ˈa j i
πλάγιασες|p l ˈa j a s ˌe s
πλάι|p l ˈaɪ
πλάκωσε|p l ˈa k o s ˌe
πλάτανος|p l ˈa t a n ˌo s
πλάτανου|p l ˈa t a n ˌu
πλέκει|p l ˈe c i
πλένει|p l ˈe n i
πλένω|p l ˈe n o
πλέξει|p l ˈe k s i
πλήθος|p l ˈi θ o s
πλήρωνε|p l ˈi r o n ˌe
πλήρωσε|p l ˈi r o s ˌe
πλαγινό|p l ˌa j i n ˈo
πλαδαρή|p l ˌa ð a r ˈi
πλακώσει|p l a k ˈo s i
πλαστικό|p l ˌa s t i k ˈo
πλατάνων|p l a t ˈa n o n
πλατείας|p l a t ˈi  a s
πλατύ|p l a t ˈi
πλευρό|p l e v r ˈo
πληγές|p l i j ˈe s
πληγή|p l i j ˈi
πληγιάσει|p l i j ˈa s i
πληγωμένο|p l ˌi ɣ o m ˈe n o
πληγωμένος|p l ˌi ɣ o m ˈe n o s
πληγώθηκες|p l i ɣ ˈo θ i c ˌe s
πληθυσμός|p l ˌi θ i s m ˈo s
πληκτρολογεί|p l ˌi k t r o l o j ˈi
πληκτρολόγιο|p l ˌi k t r o l ˈo j o
πλημμύριζε|p l i m ˈi r i z ˌe
πληροφορίες|p l ˌi r o f o r ˈi  e s
πληρωθούν|p l ˌi r o θ ˈu n
πληρωμή|p l ˌi r o m ˈi
πληρώνει|p l i r ˈo n i
πληρώνεις|p l i r ˈo n i s
πληρώνουν|p l i r ˈo n u n
πληρώνω|p l i r ˈo n o
πληρώσει|p l i r ˈo s i
πληρώσετε|p l i r ˈo s e t ˌe
πληρώσω|p l i r ˈo s o
πλησίαζε|p l i s ˈi  a z ˌe
πλησίασε|p l i s ˈi  a s ˌe
πλησιάζει|p l i s j ˈa z i
πλησιάσει|p l i s j ˈa s i
πλησιάσουν|p l i s j ˈa s u n
πλουμιστή|p l ˌu m i s t ˈi
πλουσιοντυμένος|p l ˌu s j o d i m ˈe n o s
πλουφ|p l ˈu f
πλούσια|p l ˈu s j a
πλούσιο|p l ˈu s j o
πλούσιους|p l ˈu s j u s
πλούτη|p l ˈu t i
πλωτές|p l o t ˈe s
πλωτή|p l o t ˈi
πλύνεις|p l ˈi n i s
πλώρη|p l ˈo r i
πνίγοντας|p n ˈi ɣ o d ˌa s
πνιγεί|p n i j ˈi
πνιγμένη|p n i ɣ m ˈe n i
ποδήματα|p o ð ˈi m a t ˌa
ποδαράκια|p ˌo ð a r ˈa c a
ποδιά|p ˌo ð i  ˈa
ποδοπατούν|p ˌo ð o p a t ˈu n
ποικιλία|p ˌi c i l ˈi  a
ποιο|p ˈi  o
ποιον|p ˈi  o n
ποιος|p ˈi  o s
ποκάμισο|p o k ˈa m i s ˌo
ποκαμίσου|p ˌo k a m ˈi s u
πολέμα|p o l ˈe m a
πολέμησαν|p o l ˈe m i s ˌa n
πολέμου|p o l ˈe m u
πολίτες·|p o l ˈi t e s
πολεμάνε|p ˌo l e m ˈa n e
πολεμήσει|p ˌo l e m ˈi s i
πολεμήσεις|p ˌo l e m ˈi s i s
πολεμήσομε|p ˌo l e m ˈi s o m ˌe
πολεμήσουν|p ˌo l e m ˈi s u n
πολεμούν|p ˌo l e m ˈu n
πολεμούσε|p ˌo l e m ˈu s e
πολεμώντας|p ˌo l e m ˈo d a s
πολλά|p o l ˈa
πολλές|p o l ˈe s
πολλή|p o l ˈi
πολλήν|p o l ˈi n
πολλαπλασιαστεί|p ˌo l a p l ˌa s j a s t ˈi
πολλούς|p o l ˈu s
πολυδωρος|p ˌo l i ð ˈo r o s
πολυδωρου|p ˌo l i ð ˈo r u
πολυθρόνα|p ˌo l i θ r ˈo n a
πολυτιμότερα|p ˌo l i t i m ˈo t e r ˌa
πολυτρανότατε|p ˌo l i t r a n ˈo t a t ˌe
πολυφαγία|p ˌo l i f a j ˈi  a
πολυφορεμένη|p ˌo l i f ˌo r e m ˈe n i
πολύ|p o l ˈi
πολύδω|p o l ˈi ð o
πολύδωρε|p o l ˈi ð o r ˌe
πολύδωρο|p o l ˈi ð o r ˌo
πολύδωρος|p o l ˈi ð o r ˌo s
πολύδωρου|p o l ˈi ð o r ˌu
πολύκαρπε|p o l ˈi k a r p ˌe
πολύκαρπο|p o l ˈi k a r p ˌo
πολύκαρπος|p o l ˈi k a r p ˌo s
πολύκαρπου|p o l ˈi k a r p ˌu
πολύτιμα|p o l ˈi t i m ˌa
πολύτιμες|p o l ˈi t i m ˌe s
πολύτιμη|p o l ˈi t i m ˌi
πολύτιμο|p o l ˈi t i m ˌo
πονεί|p o n ˈi
πονηρή|p ˌo n i r ˈi
πονηριά|p ˌo n i r i  ˈa
πονηρός|p ˌo n i r ˈo s
πονούσα|p o n ˈu s a
ποντίκια|p o d ˈi c a
πονώ|p o n ˈo
πορτοκάλια|p ˌo r t o k ˈa ʎ a
πορτοκαλιές|p ˌo r t o k a ʎ ˈe s
ποτάμι|p o t ˈa m i
ποτήρι|p o t ˈi r i
ποτήρια|p o t ˈi r i  ˌa
ποταμού|p ˌo t a m ˈu
ποταμό|p ˌo t a m ˈo
που|p ˈu
πουγγί|p u ŋ ɡ ˈi
πουλά|p u l ˈa
πουλάκια|p u l ˈa c a
πουλάς|p u l ˈa s
πουλήσει|p u l ˈi s i
πουλήσεις|p u l ˈi s i s
πουλήσουμε|p u l ˈi s u m ˌe
πουλήσω|p u l ˈi s o
πουλα|p ˈu l a
πουλερικά|p ˌu l e r i k ˈa
πουληθεί|p ˌu l i θ ˈi
πουληθούν|p ˌu l i θ ˈu n
πουλημένος|p ˌu l i m ˈe n o s
πουλιά|p u ʎ ˈa
πουλούν|p u l ˈu n
πουλούσαμε|p u l ˈu s a m ˌe
πουλούσαν|p u l ˈu s a n
πουλώντας|p u l ˈo d a s
πουν|p ˈu n
πού|p ˈu
πούλησαν|p ˈu l i s ˌa n
πούλησε|p ˈu l i s ˌe
πούλησες|p ˈu l i s ˌe s
πούληση|p ˈu l i s ˌi
πούμε|p ˈu m e
πούπουλο|p ˈu p u l ˌo
πράγματά|p r ˈa ɣ m a t ˈa
πράγματα|p r ˈa ɣ m a t ˌa
πράμα|p r ˈa m a
πράματα|p r ˈa m a t ˌa
πράξη|p r ˈa k s i
πράσινα|p r ˈa s i n ˌa
πράσινες|p r ˈa s i n ˌe s
πράσινη|p r ˈa s i n ˌi
πράσινο|p r ˈa s i n ˌo
πρήστηκαν|p r ˈi s t i k ˌa n
πρίμα|p r ˈi m a
πρακτική|p r ˌa k t i c ˈi
πρασινάδα|p r ˌa s i n ˈa ð a
πριν|p r ˈi n
πρισμένα|p r i s m ˈe n a
προβατά|p r ˌo v a t ˈa
προβατίνες|p r ˌo v a t ˈi n e s
προδότη|p r o ð ˈo t i
προδότης|p r o ð ˈo t i s
προδώσει|p r o ð ˈo s i
προηγούμενη|p r oɪ ɣ ˈu m e n ˌi
προκόβει|p r o k ˈo v i
προκύπτουν|p r o c ˈi p t u n
προλάβει|p r o l ˈa v i
προλάβω|p r o l ˈa v o
προμήθευε|p r o m ˈi θ e v ˌe
προς|p r ˈo s
προσέξει|p r o s ˈe k s i
προσέχει|p r o s ˈe ç i
προσβολή|p r ˌo s v o l ˈi
προσδιορίζεται|p r ˌo s ð i  o r ˈi z e t ˌe
προσεύχονται|p r o s ˈe f x o d ˌe
προσθέσει|p r o s θ ˈe s i
προσκλητήριο|p r ˌo s k l i t ˈi r i  ˌo
προσκόπους|p r o s k ˈo p u s
προσκύνησαν|p r o s c ˈi n i s ˌa n
προσοχή|p r ˌo s o ç ˈi
προσπάθησα|p r o s p ˈa θ i s ˌa
προσπάθησε|p r o s p ˈa θ i s ˌe
προσπάθησες|p r o s p ˈa θ i s ˌe s
προσπαθούσε|p r ˌo s p a θ ˈu s e
προσπαθώντας|p r ˌo s p a θ ˈo d a s
προστάξει|p r o s t ˈa k s i
προσταγές|p r ˌo s t a j ˈe s
προσταγή|p r ˌo s t a j ˈi
προστακτικό|p r ˌo s t a k t i k ˈo
προστατέψει|p r ˌo s t a t ˈe p s i
προστατεύσει|p r ˌo s t a t ˈe f s i
προστυχιάρηδες|p r ˌo s t i ç ˈa r i ð ˌe s
προσφέρει|p r o s f ˈe r i
προσφέροντας|p r o s f ˈe r o d ˌa s
προσωπική|p r ˌo s o p i c ˈi
προτάσεις|p r o t ˈa s i s
προτείνει|p r o t ˈi n i
προτείνεις|p r o t ˈi n i s
προτείνω|p r o t ˈi n o
προτού|p r o t ˈu
προφέροντας|p r o f ˈe r o d ˌa s
προφθάσει|p r o f θ ˈa s i
προφθάσομε|p r o f θ ˈa s o m ˌe
προφθάσω|p r o f θ ˈa s o
προφθαίνεις|p r o f θ ˈe n i s
προφθαίνω|p r o f θ ˈe n o
προφτάσει|p r o f t ˈa s i
προφυλάξει|p r ˌo f i l ˈa k s i
προφυλαχθούν|p r ˌo f i l a x θ ˈu n
προχθές|p r o x θ ˈe s
προχωρήσει|p r ˌo x o r ˈi s i
προχωρήσουν|p r ˌo x o r ˈi s u n
προχωρεί|p r ˌo x o r ˈi
προχωρούσε|p r ˌo x o r ˈu s e
προχώρησαν|p r o x ˈo r i s ˌa n
προχώρησε|p r o x ˈo r i s ˌe
προϊόντα|p r oɪ ˈo d a
προϊόντων|p r oɪ ˈo d o n
πρωί|p r o ˈi
πρωινή|p r ˌo i n ˈi
πρωινής|p r ˌo i n ˈi s
πρωινό|p r ˌo i n ˈo
πρωτοβγαίναν|p r ˌo t o v j ˈe n a n
πρωτοβεστιάριο|p r ˌo t o v ˌe s t i  ˈa r i  ˌo
πρωτοβεστιάριος|p r ˌo t o v ˌe s t i  ˈa r i  ˌo s
πρωτοβεστιάριου|p r ˌo t o v ˌe s t i  ˈa r i  ˌu
πρωτοκάνω|p r ˌo t o k ˈa n o
πρωτομάστ|p r ˌo t o m ˈa s t
πρωτομάστορη|p r ˌo t o m ˈa s t o r ˌi
πρωτομάστορης|p r ˌo t o m ˈa s t o r ˌi s
πρωτύτερα|p r o t ˈi t e r ˌa
πρόβατα|p r ˈo v a t ˌa
πρόγραμμα|p r ˈo ɣ r a m ˌa
πρόκοβαν|p r ˈo k o v ˌa n
πρόλαβε|p r ˈo l a v ˌe
πρόσεχε|p r ˈo s e ç ˌe
πρόσθεσε|p r ˈo s θ e s ˌe
πρόσκληση|p r ˈo s k l i s ˌi
πρόσκοποι|p r ˈo s k o p ˌi
πρόσταξε|p r ˈo s t a k s ˌe
πρόστυχη|p r ˈo s t i ç ˌi
πρόσφατα|p r ˈo s f a t ˌa
πρόσφερε|p r ˈo s f e r ˌe
πρόσωπα|p r ˈo s o p ˌa
πρόταση|p r ˈo t a s ˌi
πρότεινε|p r ˈo t i n ˌe
πρόφθαινα|p r ˈo f θ e n ˌa
πρόφθαινε|p r ˈo f θ e n ˌe
πρόφθαινες|p r ˈo f θ e n ˌe s
πρόφθασαν|p r ˈo f θ a s ˌa n
πρόφθασε|p r ˈo f θ a s ˌe
πρόχειρη|p r ˈo ç i r ˌi
πρύμη|p r ˈi m i
πρώτα|p r ˈo t a
πρώτες|p r ˈo t e s
πρώτη|p r ˈo t i
πρώτο|p r ˈo t o
πρώτοβγαίναν|p r ˈo t o v j ˈe n a n
πρώτοι|p r ˈo t i
πρώτος|p r ˈo t o s
πρώτου|p r ˈo t u
πτώμα|p t ˈo m a
πυκνά|p i k n ˈa
πυρετική|p ˌi r e t i c ˈi
πυροσβεστικό|p ˌi r o s v ˌe s t i k ˈo
πυρωμένα|p ˌi r o m ˈe n a
πυρωμένο|p ˌi r o m ˈe n o
πω|p ˈo
πως|p ˈo s
πόδι|p ˈo ð i
πόδια|p ˈo ð j a
πόθο|p ˈo θ o
πόλεμο|p ˈo l e m ˌo
πόλεμος|p ˈo l e m ˌo s
πόλη|p ˈo l i
πόνο|p ˈo n o
πόνος|p ˈo n o s
πόρτα|p ˈo r t a
πόρτες|p ˈo r t e s
πόσα|p ˈo s a
πόσες|p ˈo s e s
πόση|p ˈo s i
πόσο|p ˈo s o
πόσοι|p ˈo s i
πόσον|p ˈo s o n
πότε|p ˈo t e
πότιζαν|p ˈo t i z ˌa n
πύργος|p ˈi r ɣ o s
πύργους|p ˈi r ɣ u s
πώς|p ˈo s
ράβει|r ˈa v i
ράβεις|r ˈa v i s
ράφτρα|r ˈa f t r a
ράχη|r ˈa ç i
ράψει|r ˈa p s i
ράψετε|r ˈa p s e t ˌe
ράψουν|r ˈa p s u n
ρέμβαζε|r ˈe m v a z ˌe
ρήγα|r ˈi ɣ a
ρήγας|r ˈi ɣ a s
ρήμαγμα|r ˈi m a ɣ m ˌa
ρήμαζαν|r ˈi m a z ˌa n
ρήμαξαν|r ˈi m a k s ˌa n
ρίγανη|r ˈi ɣ a n ˌi
ρίζα|r ˈi z a
ρίζες|r ˈi z e s
ρίζωμα|r ˈi z o m ˌa
ρίξε|r ˈi k s e
ρίξει|r ˈi k s i
ρίξουν|r ˈi k s u n
ρίχθηκαν|r ˈi x θ i k ˌa n
ρίχθηκε|r ˈi x θ i c ˌe
ρίχνεσαι|r ˈi x n e s ˌe
ρίχνοντας|r ˈi x n o d ˌa s
ρίχνουν|r ˈi x n u n
ρίχνω|r ˈi x n o
ραγισμένο|r ˌa j i s m ˈe n o
ρεματιές|r ˌe m a t i  ˈe s
ρεύμα|r ˈe v m a
ρημάζει|r i m ˈa z i
ρημάξανε|r i m ˈa k s a n ˌe
ρημαγμένο|r ˌi m a ɣ m ˈe n o
ριχθούν|r i x θ ˈu n
ριχθώ|r i x θ ˈo
ριχμένο|r i x m ˈe n o
ροδάνι|r o ð ˈa n i
ροδοκόκκινη|r ˌo ð o k ˈo c i n ˌi
ρου|r ˈu
ρουφήξει|r u f ˈi k s i
ρουχάλιζαν|r u x ˈa l i z ˌa n
ρούσε|r ˈu s e
ρούχα|r ˈu x a
ρούχο|r ˈu x o
ρούχου|r ˈu x u
ρυάκι|r i  ˈa c i
ρυακιού|r ˌi  a c ˈu
ρωτάει|r o t ˈa i
ρωτάς|r o t ˈa s
ρωτήματα|r o t ˈi m a t ˌa
ρωτήσει|r o t ˈi s i
ρωτήσομε|r o t ˈi s o m ˌe
ρωτήσουμε|r o t ˈi s u m ˌe
ρωτήσουν|r o t ˈi s u n
ρωτήσω|r o t ˈi s o
ρωτώντας|r o t ˈo d a s
ρόδα|r ˈo ð a
ρόδινα|r ˈo ð i n ˌa
ρύζι|r ˈi z i
ρώτα|r ˈo t a
ρώτησαν|r ˈo t i s ˌa n
ρώτησε|r ˈo t i s ˌe
ρώτησες|r ˈo t i s ˌe s
σ'|s ˈi ɣ m a
σάβανο|s ˈa v a n ˌo
σάκο|s ˈa k o
σάλες|s ˈa l e s
σάλπιγγας|s ˈa l p i ŋ ɡ ˌa s
σάπιζαν|s ˈa p i z ˌa n
σάπιζε|s ˈa p i z ˌe
σάστισή|s ˈa s t i s ˈi
σάστισε|s ˈa s t i s ˌe
σάστιση|s ˈa s t i s ˌi
σέβεται|s ˈe v e t ˌe
σέλα|s ˈe l a
σένα|s ˈe n a
σέρνει|s ˈe r n i
σέρνοντας|s ˈe r n o d ˌa s
σήκω|s ˈi k o
σήκωναν|s ˈi k o n ˌa n
σήκωνε|s ˈi k o n ˌe
σήκωσαν|s ˈi k o s ˌa n
σήκωσε|s ˈi k o s ˌe
σήμανε|s ˈi m a n ˌe
σήμερα|s ˈi m e r ˌa
σίγουρος|s ˈi ɣ u r ˌo s
σίδερα|s ˈi ð e r ˌa
σίδερο|s ˈi ð e r ˌo
σίμωναν|s ˈi m o n ˌa n
σίμωσαν|s ˈi m o s ˌa n
σίμωσε|s ˈi m o s ˌe
σα|s ˈa
σαΐτα|s a ˈi t a
σαΐτες|s a ˈi t e s
σαίτες|s ˈe t e s
σακούλα|s a k ˈu l a
σακούλες|s a k ˈu l e s
σακούλι|s a k ˈu l i
σαλπιγκτές|s ˌa l p i ŋ ɡ t ˈe s
σαν|s ˈa n
σανίδα|s a n ˈi ð a
σανιδένιο|s ˌa n i ð ˈe ɲ o
σαπίζανε|s a p ˈi z a n ˌe
σαπίζουν|s a p ˈi z u n
σαπιοσάνιδα|s ˌa p ç o s ˈa n i ð ˌa
σαράβαλα|s a r ˈa v a l ˌa
σαρακοφαγωμένα|s ˌa r a k ˌo f a ɣ o m ˈe n a
σας|s ˈa s
σαστισμένα|s ˌa s t i s m ˈe n a
σαστισμένες|s ˌa s t i s m ˈe n e s
σαστισμένη|s ˌa s t i s m ˈe n i
σαστισμένο|s ˌa s t i s m ˈe n o
σαστισμένοι|s ˌa s t i s m ˈe n i
σαστισμένος|s ˌa s t i s m ˈe n o s
σατανικό|s ˌa t a n i k ˈo
σαχνισί|s ˌa x n i s ˈi
σαϊτεύουν|s aɪ t ˈe v u n
σβήσει|s v ˈi s i
σβησμένη|s v i s m ˈe n i
σβηστή|s v i s t ˈi
σγουρά|s ɣ u r ˈa
σγουρό|s ɣ u r ˈo
σε|s ˈe
σείστηκαν|s ˈi s t i k ˌa n
σεβασμό|s ˌe v a s m ˈo
σεβαστού|s ˌe v a s t ˈu
σεις|s ˈi s
σεκιουριτάς|s ˌe c u r i t ˈa s
σελίδα|s e l ˈi ð a
σελίδες|s e l ˈi ð e s
σεντούκι|s e d ˈu c i
σεντούκια|s e d ˈu c a
σερβιρισμένη|s ˌe r v i r i s m ˈe n i
σερβιρισμένο|s ˌe r v i r i s m ˈe n o
σεργιάνιζαν|s e r j ˈa n i z ˌa n
ση|s ˈi
σηκωθεί|s ˌi k o θ ˈi
σηκωθούν|s ˌi k o θ ˈu n
σηκωθώ|s ˌi k o θ ˈo
σηκώθηκαν|s i k ˈo θ i k ˌa n
σηκώθηκε|s i k ˈo θ i c ˌe
σηκώνει|s i k ˈo n i
σηκώνεται|s i k ˈo n e t ˌe
σηκώνοντας|s i k ˈo n o d ˌa s
σηκώνουνταν|s i k ˈo n u d ˌa n
σηκώσαμε|s i k ˈo s a m ˌe
σηκώσει|s i k ˈo s i
σηκώσομε|s i k ˈo s o m ˌe
σηκώσουν|s i k ˈo s u n
σηκώσω|s i k ˈo s o
σημάδεψε|s i m ˈa ð e p s ˌe
σημαίνουν|s i m ˈe n u n
σημασίας|s ˌi m a s ˈi  a s
σημεία|s i m ˈi  a
σημείο|s i m ˈi  o
σημερινού|s ˌi m e r i n ˈu
σιάξομε|s j ˈa k s o m ˌe
σιάξω|s j ˈa k s o
σιγά|s i ɣ ˈa
σιγανά|s ˌi ɣ a n ˈa
σιδερά|s ˌi ð e r ˈa
σιδεράδες|s ˌi ð e r ˈa ð e s
σιδεράδικο|s ˌi ð e r ˈa ð i k ˌo
σιδεράς|s ˌi ð e r ˈa s
σιδερένια|s ˌi ð e r ˈe ɲ a
σιδερένιο|s ˌi ð e r ˈe ɲ o
σιδερόπετρες|s ˌi ð e r ˈo p e t r ˌe s
σιδηρουργείο|s ˌi ð i r u r j ˈi  o
σιμώνοντας|s i m ˈo n o d ˌa s
σιμώσουν|s i m ˈo s u n
σιτάρι|s i t ˈa r i
σιτάρια|s i t ˈa r i  ˌa
σιωπή|s j o p ˈi
σιωπηλά|s j ˌo p i l ˈa
σιωπηλή|s j ˌo p i l ˈi
σκάβει|s k ˈa v i
σκάβετε|s k ˈa v e t ˌe
σκάβουν|s k ˈa v u n
σκάβω|s k ˈa v o
σκάκι|s k ˈa c i
σκάλα|s k ˈa l a
σκάλισα|s k ˈa l i s ˌa
σκάλισε|s k ˈa l i s ˌe
σκάλωσε|s k ˈa l o s ˌe
σκάσω|s k ˈa s o
σκάψει|s k ˈa p s i
σκάψομε|s k ˈa p s o m ˌe
σκέπαζα|s c ˈe p a z ˌa
σκέπαζαν|s c ˈe p a z ˌa n
σκέπαζε|s c ˈe p a z ˌe
σκέπασε|s c ˈe p a s ˌe
σκέπασμα|s c ˈe p a s m ˌa
σκέπτεται|s c ˈe p t e t ˌe
σκέπτουνταν|s c ˈe p t u d ˌa n
σκέφθηκα|s c ˈe f θ i k ˌa
σκέφθηκε|s c ˈe f θ i c ˌe
σκέφτηκε|s c ˈe f t i c ˌe
σκέψεις|s c ˈe p s i s
σκέψη|s c ˈe p s i
σκήπτρο|s c ˈi p t r o
σκίνος|s c ˈi n o s
σκαλίσομε|s k a l ˈi s o m ˌe
σκαλίσουμε|s k a l ˈi s u m ˌe
σκαλίτσα|s k a l ˈi ts a
σκαλισμένο|s k ˌa l i s m ˈe n o
σκαλοπάτια|s k ˌa l o p ˈa t i  ˌa
σκαλος|s k ˈa l o s
σκαλώσει|s k a l ˈo s i
σκαμνί|s k a m n ˈi
σκανδαλισμένο|s k ˌa n ð a l i s m ˈe n o
σκαρφάλωσαν|s k a r f ˈa l o s ˌa n
σκαρφάλωσε|s k a r f ˈa l o s ˌe
σκαρφαλώνοντας|s k ˌa r f a l ˈo n o d ˌa s
σκεπάζονταν|s c e p ˈa z o d ˌa n
σκεπάζοντας|s c e p ˈa z o d ˌa s
σκεπάζουνταν|s c e p ˈa z u d ˌa n
σκεπάστηκε|s c e p ˈa s t i c ˌe
σκεπασμένα|s c ˌe p a s m ˈe n a
σκεπασμένο|s c ˌe p a s m ˈe n o
σκεπαστεί|s c ˌe p a s t ˈi
σκεπαστός|s c ˌe p a s t ˈo s
σκεπτικός|s c ˌe p t i k ˈo s
σκερπάνι|s c e r p ˈa n i
σκεφθούν|s c e f θ ˈu n
σκεφτεί|s c e f t ˈi
σκηνές|s c i n ˈe s
σκηνή|s c i n ˈi
σκιά|s c ˈa
σκιάζοντας|s c ˈa z o d ˌa s
σκιερή|s c e r ˈi
σκληρού|s k l i r ˈu
σκληρό|s k l i r ˈo
σκοίνος|s c ˈi n o s
σκοίνου|s c ˈi n u
σκοινί|s c i n ˈi
σκοινιά|s c i ɲ ˈa
σκονάκια|s k o n ˈa c a
σκονισμένο|s k ˌo n i s m ˈe n o
σκονισμένος|s k ˌo n i s m ˈe n o s
σκοντάφτοντας|s k o d ˈa f t o d ˌa s
σκοπού|s k o p ˈu
σκοπό|s k o p ˈo
σκορδαλιά|s k ˌo r ð a ʎ ˈa
σκορπάς·|s k o r p ˈa s
σκορπίσουν|s k o r p ˈi s u n
σκορπίστηκαν|s k o r p ˈi s t i k ˌa n
σκορπισμένα|s k ˌo r p i s m ˈe n a
σκορπισμένες|s k ˌo r p i s m ˈe n e s
σκορπισμένοι|s k ˌo r p i s m ˈe n i
σκορπιστεί|s k ˌo r p i s t ˈi
σκορπούσαν|s k o r p ˈu s a n
σκορπούσε|s k o r p ˈu s e
σκοτάδι|s k o t ˈa ð i
σκοτεινά|s k ˌo t i n ˈa
σκοτισμένο|s k ˌo t i s m ˈe n o
σκοτούρες|s k o t ˈu r e s
σκοτωθεί|s k ˌo t o θ ˈi
σκοτωθούμε|s k ˌo t o θ ˈu m e
σκοτωμένο|s k ˌo t o m ˈe n o
σκοτωμένους|s k ˌo t o m ˈe n u s
σκοτώθηκε|s k o t ˈo θ i c ˌe
σκοτώνομε|s k o t ˈo n o m ˌe
σκοτώνουν|s k o t ˈo n u n
σκοτώσει|s k o t ˈo s i
σκοτώσεις|s k o t ˈo s i s
σκοτώσομε|s k o t ˈo s o m ˌe
σκοτώσω|s k o t ˈo s o
σκουντάει|s k u d ˈa i
σκουντουφλήσει|s k ˌu d u f l ˈi s i
σκουντουφλιούνταν|s k ˌu d u f ʎ ˈu d a n
σκουντούφλησε|s k u d ˈu f l i s ˌe
σκουπίζει|s k u p ˈi z i
σκουπίζοντας|s k u p ˈi z o d ˌa s
σκουριά|s k ˌu r i  ˈa
σκουριασμένη|s k ˌu r i  a s m ˈe n i
σκουφί|s k u f ˈi
σκούπα|s k ˈu p a
σκούπιζαν|s k ˈu p i z ˌa n
σκούπιζε|s k ˈu p i z ˌe
σκούπισε|s k ˈu p i s ˌe
σκούρα|s k ˈu r a
σκούριαζαν|s k ˈu r i  ˌa z a n
σκούφια|s k ˈu f i  ˌa
σκυλιά|s c i ʎ ˈa
σκυμμένα|s c i m ˈe n a
σκυμμένη|s c i m ˈe n i
σκυμμένο|s c i m ˈe n o
σκυμμένος|s c i m ˈe n o s
σκυφτό|s c i f t ˈo
σκόνη|s k ˈo n i
σκόρπια|s k ˈo r p ç a
σκότισα|s k ˈo t i s ˌa
σκότισες|s k ˈo t i s ˌe s
σκότωναν|s k ˈo t o n ˌa n
σκότωνε|s k ˈo t o n ˌe
σκότωσε|s k ˈo t o s ˌe
σκύβοντας|s c ˈi v o d ˌa s
σμέουρα|s m ˈe u r ˌa
σμίγει|s m ˈi j i
σμίγοντας|s m ˈi ɣ o d ˌa s
σμαράγδια|s m a r ˈa ɣ ð j a
σμαραγδένιο|s m ˌa r a ɣ ð ˈe ɲ o
σμεουριά|s m ˌe u r i  ˈa
σοβάδες|s o v ˈa ð e s
σοβαρά|s ˌo v a r ˈa
σοβαρό|s ˌo v a r ˈo
σοβαρότατα|s ˌo v a r ˈo t a t ˌa
σοδειές|s o ð ç ˈe s
σου|s ˈu
σου»|s ˈu
σουφρωμένα|s ˌu f r o m ˈe n a
σοφίτας|s o f ˈi t a s
σούβλισε|s ˈu v l i s ˌe
σούζα|s ˈu z a
σούπα|s ˈu p a
σούπας|s ˈu p a s
σούπες|s ˈu p e s
σούφρωσε|s ˈu f r o s ˌe
σπάγγους|s p ˈa ŋ ɡ u s
σπάσαμε|s p ˈa s a m ˌe
σπάσε|s p ˈa s e
σπάσετε|s p ˈa s e t ˌe
σπάτουλα|s p ˈa t u l ˌa
σπίνος|s p ˈi n o s
σπίτια|s p ˈi t i  ˌa
σπαθί|s p a θ ˈi
σπαθιά|s p ˌa θ i  ˈa
σπαραξικάρδιο|s p ˌa r a k s i k ˈa r ð i  ˌo
σπαρμένα|s p a r m ˈe n a
σπαρμένη|s p a r m ˈe n i
σπαρτά|s p a r t ˈa
σπασμένης|s p a s m ˈe n i s
σπείρει|s p ˈi r i
σπείρεις|s p ˈi r i s
σπείρομε|s p ˈi r o m ˌe
σπιθοβολούσαν|s p ˌi θ o v o l ˈu s a n
σπιτάκι|s p i t ˈa c i
σπιτάκια|s p i t ˈa c a
σπιτιού|s p ˌi t i  ˈu
σπούσα|s p ˈu s a
σπούσαν|s p ˈu s a n
σπρωξιά|s p r ˌo k s i  ˈa
σπρωξιές|s p r ˌo k s i  ˈe s
σπρώξε|s p r ˈo k s e
σπρώξει|s p r ˈo k s i
σπρώχνει|s p r ˈo x n i
σπρώχνοντας|s p r ˈo x n o d ˌa s
σπόρο|s p ˈo r o
στ'|s ˌi ɣ m a t ˈa f
στάβλους|s t ˈa v l u s
στάθηκε|s t ˈa θ i c ˌe
στάλες|s t ˈa l e s
στάμνα|s t ˈa m n a
στάση|s t ˈa s i
στάσου|s t ˈa s u
στάχτες|s t ˈa x t e s
στάχυα|s t ˈa ç a
στέγη|s t ˈe j i
στέγνωσε|s t ˈe ɣ n o s ˌe
στέκεσαι|s t ˈe c e s ˌe
στέκουνταν|s t ˈe k u d ˌa n
στέλναμε|s t ˈe l n a m ˌe
στέλνει|s t ˈe l n i
στέλνοντας|s t ˈe l n o d ˌa s
στέναξε|s t ˈe n a k s ˌe
στένευαν|s t ˈe n e v ˌa n
στέρνα|s t ˈe r n a
στέρνες|s t ˈe r n e s
στέφθηκε|s t ˈe f θ i c ˌe
στέψεως|s t ˈe p s e ˌo s
στήθη|s t ˈi θ i
στήθια|s t ˈi θ i  ˌa
στήθος|s t ˈi θ o s
στήριξε|s t ˈi r i k s ˌe
στήσει|s t ˈi s i
στίξης|s t ˈi k s i s
στα|s t ˈa
σταθεί|s t a θ ˈi
σταθείς|s t a θ ˈi s
σταθερό|s t ˌa θ e r ˈo
σταμάτησαν|s t a m ˈa t i s ˌa n
σταμάτησε|s t a m ˈa t i s ˌe
σταματήσει|s t ˌa m a t ˈi s i
σταματήσεις|s t ˌa m a t ˈi s i s
σταματήσομε|s t ˌa m a t ˈi s o m ˌe
σταματήσουν|s t ˌa m a t ˈi s u n
σταματούσε|s t ˌa m a t ˈu s e
σταματώντας|s t ˌa m a t ˈo d a s
σταυροί|s t a v r ˈi
σταυροκοπήθηκε|s t ˌa v r o k o p ˈi θ i c ˌe
σταυρωμένα|s t ˌa v r o m ˈe n a
σταυρώνοντας|s t a v r ˈo n o d ˌa s
σταφύλι|s t a f ˈi l i
σταφύλια|s t a f ˈi ʎ a
στείλε|s t ˈi l e
στείλει|s t ˈi l i
στείλεις|s t ˈi l i s
στείλομε|s t ˈi l o m ˌe
στείλω|s t ˈi l o
στεγνή|s t e ɣ n ˈi
στεγνώσει|s t e ɣ n ˈo s i
στενάζοντας|s t e n ˈa z o d ˌa s
στενή|s t e n ˈi
στενεύει|s t e n ˈe v i
στενοχωρέθηκε|s t ˌe n o x o r ˈe θ i c ˌe
στενοχωρεί|s t ˌe n o x o r ˈi
στενοχωρεμένος|s t ˌe n o x ˌo r e m ˈe n o s
στενοχωρημένος|s t ˌe n o x ˌo r i m ˈe n o s
στενοχώρεσε|s t ˌe n o x ˈo r e s ˌe
στερέωνε|s t e r ˈe o n ˌe
στερέωσε|s t e r ˈe o s ˌe
στερεώσει|s t ˌe r e ˈo s i
στεριά|s t ˌe r i  ˈa
στεφανώσει|s t ˌe f a n ˈo s i
στεφανώσω|s t ˌe f a n ˈo s o
στη|s t ˈi
στην|s t ˈi n
στηριγμένος|s t ˌi r i ɣ m ˈe n o s
στιγμή|s t i ɣ m ˈi
στιγμιαία|s t ˌi ɣ m i  ˈe a
στις|s t ˈi s
στοίβα|s t ˈi v a
στοιβάζουνταν|s t i v ˈa z u d ˌa n
στοιβαγμένα|s t ˌi v a ɣ m ˈe n a
στοιβαγμένες|s t ˌi v a ɣ m ˈe n e s
στολίδια|s t o l ˈi ð j a
στολίζει|s t o l ˈi z i
στολίζεται|s t o l ˈi z e t ˌe
στολισμένες|s t ˌo l i s m ˈe n e s
στολισμένη|s t ˌo l i s m ˈe n i
στολισμένο|s t ˌo l i s m ˈe n o
στολος|s t ˈo l o s
στου|s t ˈu
στουμπώνω|s t u b ˈo n o
στουππαίων|s t u p ˈe o n
στους|s t ˈu s
στοχάστηκε|s t o x ˈa s t i c ˌe
στράγγισε|s t r ˈa ŋ ɡ i s ˌe
στράτηγοι|s t r ˈa t i j ˌi
στρίγλα|s t r ˈi ɣ l a
στρίψει|s t r ˈi p s i
στρίψει»|s t r ˈi p s i
στραβά|s t r a v ˈa
στραβή|s t r a v ˈi
στραβοκάνη|s t r ˌa v o k ˈa n i
στραβοκάνης|s t r ˌa v o k ˈa n i s
στραβομούτσουνα|s t r ˌa v o m ˈu ts u n ˌa
στραβούς|s t r a v ˈu s
στραβός|s t r a v ˈo s
στρατεύματα|s t r a t ˈe v m a t ˌa
στρατηγέ|s t r ˌa t i j ˈe
στρατηγού|s t r ˌa t i ɣ ˈu
στρατηγό|s t r ˌa t i ɣ ˈo
στρατηγός|s t r ˌa t i ɣ ˈo s
στρατιωτικά|s t r ˌa t i  ˌo t i k ˈa
στρατιωτών|s t r ˌa t i  o t ˈo n
στρατιώτες|s t r ˌa t i  ˈo t e s
στρατιώτη|s t r ˌa t i  ˈo t i
στρατιώτης|s t r ˌa t i  ˈo t i s
στρατοπέδευσαν|s t r ˌa t o p ˈe ð e f s ˌa n
στρατοπεδευμένοι|s t r ˌa t o p ˌe ð e v m ˈe n i
στρατος|s t r ˈa t o s
στρατού|s t r a t ˈu
στρατό|s t r a t ˈo
στρατό»|s t r a t ˈo
στρατός|s t r a t ˈo s
στρατώνες|s t r a t ˈo n e s
στρεσαρισμένος|s t r ˌe s a r i s m ˈe n o s
στριγκλιά|s t r i ŋ ɡ ʎ ˈa
στριγλίζει|s t r i ɣ l ˈi z i
στριγλιές|s t r i ɣ ʎ ˈe s
στρωθεί|s t r o θ ˈi
στρωμένο|s t r o m ˈe n o
στρωμένοι|s t r o m ˈe n i
στρωμένος|s t r o m ˈe n o s
στρώμα|s t r ˈo m a
στρώνουν|s t r ˈo n u n
στρώσει|s t r ˈo s i
στρώσουν|s t r ˈo s u n
στό|s t ˈo
στόλαρχο|s t ˈo l a r x ˌo
στόλαρχοι|s t ˈo l a r ç ˌi
στόλαρχος|s t ˈo l a r x ˌo s
στόλο|s t ˈo l o
στόλος|s t ˈo l o s
στόχο|s t ˈo x o
στ’|s ˌi ɣ m a t ˈa f
συ|s ˈi
συγγενή|s ˌi ŋ ɡ e n ˈi
συγγενών|s ˌi ŋ ɡ e n ˈo n
συγκάλεσε|s i ŋ ɡ ˈa l e s ˌe
συγκίνηση|s i ŋ ɡ ˈi n i s ˌi
συγκαλά|s ˌi ŋ ɡ a l ˈa
συγκεκριμένο|s ˌi ŋ ɡ e k r i m ˈe n o
συγκεντρώθηκε|s ˌi ŋ ɡ e d r ˈo θ i c ˌe
συγκινήθηκαν|s ˌi ŋ ɡ i n ˈi θ i k ˌa n
συγκινημένος|s ˌi ŋ ɡ i n i m ˈe n o s
συγκρατήσει|s ˌi ŋ ɡ r a t ˈi s i
συγυρίζω|s ˌi j i r ˈi z o
συγχωρήσεις|s ˌi ŋ x o r ˈi s i s
συγχώρηση|s i ŋ x ˈo r i s ˌi
συγύριζε|s i j ˈi r i z ˌe
συγύρισα|s i j ˈi r i s ˌa
συζήτηση|s i z ˈi t i s ˌi
συζητούσαν|s ˌi z i t ˈu s a n
συκοφάντη|s ˌi k o f ˈa d i
συλλάβεις|s i l ˈa v i s
συλλάβω|s i l ˈa v o
συλλαβές|s ˌi l a v ˈe s
συλλογή|s ˌi l o j ˈi
συλλογίζεσαι|s ˌi l o j ˈi z e s ˌe
συλλογίζουνταν|s ˌi l o j ˈi z u d ˌa n
συλλογίστηκα|s ˌi l o j ˈi s t i k ˌa
συλλογίστηκε|s ˌi l o j ˈi s t i c ˌe
συλλογίστηκες|s ˌi l o j ˈi s t i c ˌe s
συλλογιέσαι|s ˌi l o j ˈe s e
συλλογισμένα|s ˌi l o j i s m ˈe n a
συλλογισμένη|s ˌi l o j i s m ˈe n i
συλλογισμένο|s ˌi l o j i s m ˈe n o
συλλογισμένος|s ˌi l o j i s m ˈe n o s
συλλογιστεί|s ˌi l o j i s t ˈi
συλλογιστούν|s ˌi l o j i s t ˈu n
συμβαίνει|s i m v ˈe n i
συμβεί|s i m v ˈi
συμβουλές|s ˌi m v u l ˈe s
συμβουλή|s ˌi m v u l ˈi
συμμαζέψει|s ˌi m a z ˈe p s i
συμμαζέψειτους|s ˌi m a z ˈe p s i t ˌu s
συμμαζέψουν|s ˌi m a z ˈe p s u n
συμμαζευθούν|s ˌi m a z e f θ ˈu n
συμμαζεύει|s ˌi m a z ˈe v i
συμμαζεύοντας|s ˌi m a z ˈe v o d ˌa s
συμμαχία|s ˌi m a ç ˈi  a
συμμετοχή|s ˌi m e t o ç ˈi
συμπάθεια|s i b ˈa θ ç a
συμπεριφέρεται|s ˌi b e r i f ˈe r e t ˌe
συμφέρο|s i m f ˈe r o
συμφέρον|s i m f ˈe r o n
συμφέροντα|s i m f ˈe r o d ˌa
συμφωνία|s ˌi m f o n ˈi  a
συνάμα|s i n ˈa m a
συνάχι|s i n ˈa ç i
συνέβηκε|s i n ˈe v i c ˌe
συνένοχος|s i n ˈe n o x ˌo s
συνέχισε|s i n ˈe ç i s ˌe
συνήθιζε|s i n ˈi θ i z ˌe
συνήλθε|s i n ˈi l θ e
συναγερμός|s ˌi n a j e r m ˈo s
συναθροίσουν|s ˌi n a θ r ˈi s u n
συνεννοηθεί|s ˌi n e n oɪ θ ˈi
συνεργεία|s ˌi n e r j ˈi  a
συνεργείο|s ˌi n e r j ˈi  o
συνετος|s i n ˈe t o s
συνετού|s ˌi n e t ˈu
συνετού·|s ˌi n e t ˈu
συνετός|s ˌi n e t ˈo s
συνεφέρει|s ˌi n e f ˈe r i
συνεφέρω|s ˌi n e f ˈe r o
συνεχίσουμε|s ˌi n e ç ˈi s u m ˌe
συνηθισμένες|s ˌi n i θ i s m ˈe n e s
συνηθισμένι|s ˌi n i θ i s m ˈe n i
συνημμένο|s ˌi n i m ˈe n o
συννεφιασμένο|s ˌi n e f ˌi  a s m ˈe n o
συνοδεύει|s ˌi n o ð ˈe v i
συνοδεύονταν|s ˌi n o ð ˈe v o d ˌa n
συνοδεύσει|s ˌi n o ð ˈe f s i
συνολικού|s ˌi n o l i k ˈu
συνομιλούσαν|s ˌi n o m i l ˈu s a n
συντεταγμένων|s ˌi d e t a ɣ m ˈe n o n
συντομία|s ˌi d o m ˈi  a
συντρίμματα|s i d r ˈi m a t ˌa
συντροφιά|s ˌi d r o f i  ˈa
συντροφικά|s ˌi d r o f i k ˈa
συντρόφους|s i d r ˈo f u s
συρτάρι|s i r t ˈa r i
συρτάρια|s i r t ˈa r i  ˌa
συχωρεμένης|s ˌi x o r e m ˈe n i s
συχώρνα|s i x ˈo r n a
σφίχθηκε|s f ˈi x θ i c ˌe
σφανταχτερό|s f ˌa d a x t e r ˈo
σφενδόνα|s f e n ð ˈo n a
σφιγμένα|s f i ɣ m ˈe n a
σφιχτά|s f i x t ˈa
σφυρί|s f i r ˈi
σφυρίζοντας|s f i r ˈi z o d ˌa s
σφύριγμα|s f ˈi r i ɣ m ˌa
σφύριζε|s f ˈi r i z ˌe
σφύριξε|s f ˈi r i k s ˌe
σχέδια|s ç ˈe ð j a
σχέδιο|s ç ˈe ð i  ˌo
σχήμα|s ç ˈi m a
σχίσω|s ç ˈi s o
σχεδόν|s ç e ð ˈo n
σχετίζεται|s ç e t ˈi z e t ˌe
σχετίζομαι|s ç e t ˈi z o m ˌe
σχηματίζοντας|s ç ˌi m a t ˈi z o d ˌa s
σχισμένα|s ç i s m ˈe n a
σχισμένη|s ç i s m ˈe n i
σχισμένο|s ç i s m ˈe n o
σχιστεί|s ç i s t ˈi
σχολείο|s x o l ˈi  o
σχολείων|s x o l ˈi  o n
σχολική|s x ˌo l i c ˈi
σχωρέσ'|s x o r ˈe s
σωθήκαμε|s o θ ˈi k a m ˌe
σωθεί|s o θ ˈi
σωθούν|s o θ ˈu n
σωθώ|s o θ ˈo
σωκράτη|s o k r ˈa t i
σωματάρχη|s ˌo m a t ˈa r ç i
σωματάρχης|s ˌo m a t ˈa r ç i s
σωματοφυλακής|s ˌo m a t ˌo f i l a c ˈi s
σωματοφύλακες|s ˌo m a t o f ˈi l a c ˌe s
σωπάσει|s o p ˈa s i
σωπάσεις|s o p ˈa s i s
σωριάστηκε|s ˌo r i  ˈa s t i c ˌe
σωστά|s o s t ˈa
σωστό|s o s t ˈo
σωτήρα|s o t ˈi r a
σύγχιση|s ˈi ŋ ç i s ˌi
σύμβολο|s ˈi m v o l ˌo
σύμβουλος|s ˈi m v u l ˌo s
σύμμαχος|s ˈi m a x ˌo s
σύμφωνα|s ˈi m f o n ˌa
σύναξε|s ˈi n a k s ˌe
σύνεση|s ˈi n e s ˌi
σύνθημα|s ˈi n θ i m ˌa
σύννεφο|s ˈi n e f ˌo
σύντομα|s ˈi d o m ˌa
σύρομε|s ˈi r o m ˌe
σύρουμε|s ˈi r u m ˌe
σύρουν|s ˈi r u n
σύσσωμο|s ˈi s s o m ˌo
σύστησε|s ˈi s t i s ˌe
σώμα|s ˈo m a
σώπαινε|s ˈo p e n ˌe
σώσει|s ˈo s i
σώσω|s ˈo s o
τ'|t ˈa f
τάληρα|t ˈa l i r ˌa
τάλιρα|t ˈa l i r ˌa
τάξη|t ˈa k s i
τάφο|t ˈa f o
τάφος|t ˈa f o s
τέ|t ˈe
τέλος|t ˈe l o s
τέντζερέ|t ˈe d z e r ˈe
τέντζερε|t ˈe d z e r ˌe
τέρας|t ˈe r a s
τέσσερα|t ˈe s s e r ˌa
τέσσερεις|t ˈe s s e r ˌi s
τέσσερις|t ˈe s s e r ˌi s
τέτοια|t ˈe t i  ˌa
τέτοιο|t ˈe t i  ˌo
τέτοιοι|t ˈe t i  ˌi
τέτοιον|t ˈe t i  ˌo n
τέτοιους|t ˈe t i  ˌu s
τί|t ˈi
τίμια|t ˈi m i  ˌa
τίμιοι|t ˈi m i  ˌi
τίμιος|t ˈi m i  ˌo s
τίνος|t ˈi n o s
τίποτα|t ˈi p o t ˌa
τίποτε|t ˈi p o t ˌe
τίτλους|t ˈi t l u s
τα|t ˈa
ταβέρνα|t a v ˈe r n a
ταβέρνας|t a v ˈe r n a s
ταβέρνες|t a v ˈe r n e s
ταβερνα|t a v ˈe r n a
τακτικά|t ˌa k t i k ˈa
τακτικό|t ˌa k t i k ˈo
τακτοποιήσει|t ˌa k t o p i  ˈi s i
ταλαιπωράκης|t ˌa l e p o r ˈa c i s
ταξίδι|t a k s ˈi ð i
ταπεινά|t ˌa p i n ˈa
ταπεινοί|t ˌa p i n ˈi
ταπεινωμένο|t ˌa p i n o m ˈe n o
ταράχθηκαν|t a r ˈa x θ i k ˌa n
ταράχθηκε|t a r ˈa x θ i c ˌe
ταραγμένη|t ˌa r a ɣ m ˈe n i
ταραγμένος|t ˌa r a ɣ m ˈe n o s
ταρακουνάει|t ˌa r a k u n ˈa i
ταραχή|t ˌa r a ç ˈi
ταραχθεί|t ˌa r a x θ ˈi
τείνοντας|t ˈi n o d ˌa s
τειχογύριζαν|t ˌi x o j ˈi r i z ˌa n
τελείωνα|t e l ˈi  o n ˌa
τελείωνε|t e l ˈi  o n ˌe
τελείωσαν|t e l ˈi  o s ˌa n
τελείωσε|t e l ˈi  o s ˌe
τελειωμένη|t ˌe ʎ o m ˈe n i
τελειώνεις|t e ʎ ˈo n i s
τελειώνουν|t e ʎ ˈo n u n
τελειώσει|t e ʎ ˈo s i
τελειώσεις|t e ʎ ˈo s i s
τελειώσουν|t e ʎ ˈo s u n
τελειώσω|t e ʎ ˈo s o
τελετουργίες|t ˌe l e t u r j ˈi  e s
τελευταίες|t ˌe l e f t ˈe e s
τελευταίο|t ˌe l e f t ˈe o
τελευταίος|t ˌe l e f t ˈe o s
τελικά|t ˌe l i k ˈa
τεμπέλικα|t e b ˈe l i k ˌa
τενεκές|t ˌe n e c ˈe s
τενεκεδάκια|t ˌe n e c e ð ˈa c a
τενεκεδένια|t ˌe n e c e ð ˈe ɲ a
τενεκεδένιο|t ˌe n e c e ð ˈe ɲ o
τεντωμέ|t ˌe d o m ˈe
τες|t ˈe s
τετραγωνάκια|t ˌe t r a ɣ o n ˈa c a
τετραγωνικών|t ˌe t r a ɣ ˌo n i k ˈo n
τετραδίων|t ˌe t r a ð ˈi  o n
τεχνίτες|t e x n ˈi t e s
τεχνίτης|t e x n ˈi t i s
τζάμια|d z ˈa m i  ˌa
τζοτζέ|d z o d z ˈe
τζοτζές|d z o d z ˈe s
τη|t ˈi
τηλέφωνα|t i l ˈe f o n ˌa
τηλέφωνο|t i l ˈe f o n ˌo
τηλεγραφική|t ˌi l e ɣ r ˌa f i c ˈi
την|t ˈi n
της|t ˈi s
τι|t ˈi
τιμά|t i m ˈa
τιμής|t i m ˈi s
τιμημένη|t ˌi m i m ˈe n i
τιμωρήσεις|t ˌi m o r ˈi s i s
τινάχτηκε|t i n ˈa x t i c ˌe
τις|t ˈi s
τμήματα|t m ˈi m a t ˌa
τοίχο|t ˈi x o
τοίχοι|t ˈi ç i
τοίχους|t ˈi x u s
τοιες|t ˈi  e s
τολμήσει|t o l m ˈi s i
τολμήσω|t o l m ˈi s o
τον|t ˈo n
τονίζοντας|t o n ˈi z o d ˌa s
τοπάζι|t o p ˈa z i
τοπογραφικό|t ˌo p o ɣ r ˌa f i k ˈo
τοποθέτησαν|t ˌo p o θ ˈe t i s ˌa n
τοτε|t ˈo t e
του|t ˈu
τουλάχιστον|t u l ˈa ç i s t ˌo n
τους|t ˈu s
τού|t ˈu
τούμπα|t ˈu b a
τούσα|t ˈu s a
τούτα|t ˈu t a
τούτη|t ˈu t i
τούτο|t ˈu t o
τούτον|t ˈu t o n
τούτος|t ˈu t o s
τράβηξα|t r ˈa v i k s ˌa
τράβηξαν|t r ˈa v i k s ˌa n
τράβηξε|t r ˈa v i k s ˌe
τράνταξε|t r ˈa d a k s ˌe
τράπηκε|t r ˈa p i c ˌe
τρέμανε|t r ˈe m a n ˌe
τρέμει|t r ˈe m i
τρέμοντας|t r ˈe m o d ˌa s
τρέξει|t r ˈe k s i
τρέξεις|t r ˈe k s i s
τρέξιμο|t r ˈe k s i m ˌo
τρέξουν|t r ˈe k s u n
τρέφεις|t r ˈe f i s
τρέχει|t r ˈe ç i
τρέχεις|t r ˈe ç i s
τρέχετε|t r ˈe ç e t ˌe
τρέχουν|t r ˈe x u n
τρέχω|t r ˈe x o
τρία|t r ˈi  a
τρίβει|t r ˈi v i
τρίτη|t r ˈi t i
τρίτο|t r ˈi t o
τραβάτε|t r a v ˈa t e
τραβήξει|t r a v ˈi k s i
τραβήξουν|t r a v ˈi k s u n
τραβήχθηκε|t r a v ˈi x θ i c ˌe
τραβηγμένο|t r ˌa v i ɣ m ˈe n o
τραβούμε|t r a v ˈu m e
τραβούν|t r a v ˈu n
τραβούσα|t r a v ˈu s a
τραβούσαν|t r a v ˈu s a n
τραβώντας|t r a v ˈo d a s
τραγουδιστά|t r ˌa ɣ u ð i s t ˈa
τραγουδούσε|t r ˌa ɣ u ð ˈu s e
τραγουδώντας|t r ˌa ɣ u ð ˈo d a s
τραγούδι|t r a ɣ ˈu ð i
τραγούδια|t r a ɣ ˈu ð j a
τρανά|t r a n ˈa
τρανταχτερή|t r ˌa d a x t e r ˈi
τρανό|t r a n ˈo
τρανός|t r a n ˈo s
τραπέζ|t r a p ˈe z
τραπε|t r ˈa p e
τραπεζίτη|t r ˌa p e z ˈi t i
τραπεζαρία|t r ˌa p e z a r ˈi  a
τραχηλιά|t r ˌa ç i ʎ ˈa
τρεις|t r ˈi s
τρελάθηκαν|t r e l ˈa θ i k ˌa n
τρελό|t r e l ˈo
τρελόρεμα|t r e l ˈo r e m ˌa
τρελός|t r e l ˈo s
τρεμουλιάρικη|t r ˌe m u ʎ ˈa r i c ˌi
τρεμουλιαστά|t r ˌe m u ʎ a s t ˈa
τρεμουλιαστή|t r ˌe m u ʎ a s t ˈi
τρεμούλα|t r e m ˈu l a
τρεχάτε|t r e x ˈa t e
τρεχάτη|t r e x ˈa t i
τρεχάτος|t r e x ˈa t o s
τριανταφυλλιά|t r ˌi  a d ˌa f i ʎ ˈa
τρισχειρότερο|t r ˌi s ç i r ˈo t e r ˌo
τριών|t r i  ˈo n
τρομάζεις|t r o m ˈa z i s
τρομάξαμε|t r o m ˈa k s a m ˌe
τρομάξω|t r o m ˈa k s o
τρομάρα|t r o m ˈa r a
τρομαγμένα|t r ˌo m a ɣ m ˈe n a
τρομαγμένες|t r ˌo m a ɣ m ˈe n e s
τρομαγμένοι|t r ˌo m a ɣ m ˈe n i
τρομαγμένος|t r ˌo m a ɣ m ˈe n o s
τρομερό|t r ˌo m e r ˈo
τροποποιήθηκε|t r ˌo p o p i  ˈi θ i c ˌe
τροφές|t r o f ˈe s
τροφαντά|t r ˌo f a d ˈa
τροφαντό|t r ˌo f a d ˈo
τροχούς|t r o x ˈu s
τρυπήσει|t r i p ˈi s i
τρυπημένη|t r ˌi p i m ˈe n i
τρυπούν|t r i p ˈu n
τρυπούσαν|t r i p ˈu s a n
τρως|t r ˈo s
τρόμαξαν|t r ˈo m a k s ˌa n
τρόμαξε|t r ˈo m a k s ˌe
τρόμο|t r ˈo m o
τρόμος|t r ˈo m o s
τρόπο|t r ˈo p o
τρόπος|t r ˈo p o s
τρόπους|t r ˈo p u s
τρύπα|t r ˈi p a
τρύπες|t r ˈi p e s
τρύπησαν|t r ˈi p i s ˌa n
τρύπησε|t r ˈi p i s ˌe
τρύπια|t r ˈi p ç a
τρώγει|t r ˈo j i
τρώγουν|t r ˈo ɣ u n
τρώμε|t r ˈo m e
τρώνε|t r ˈo n e
τσάκιζε|ts ˈa c i z ˌe
τσάκισαν|ts ˈa c i s ˌa n
τσάκισε|ts ˈa c i s ˌe
τσάπα|ts ˈa p a
τσάπες|ts ˈa p e s
τσέπες|ts ˈe p e s
τσέπη|ts ˈe p i
τσίμπησε|ts ˈi b i s ˌe
τσίρο|ts ˈi r o
τσίροι|ts ˈi r i
τσίρους|ts ˈi r u s
τσαμπί|ts a b ˈi
τσεκουριές|ts ˌe k u r i  ˈe s
τσεκούρι|ts e k ˈu r i
τσιγάριζε|ts i ɣ ˈa r i z ˌe
τσιμπίδα|ts i b ˈi ð a
τσιμπούκι|ts i b ˈu c i
τσιμπούν|ts i b ˈu n
τσιριχτό|ts ˌi r i x t ˈo
τσοπάνη|ts o p ˈa n i
τσουγκρανιά|ts ˌu ŋ ɡ r a ɲ ˈa
τσούζει|ts ˈu z i
τυλίχθηκε|t i l ˈi x θ i c ˌe
τυλιγμένο|t ˌi l i ɣ m ˈe n o
τυλιγμένος|t ˌi l i ɣ m ˈe n o s
τυποδέψουν|t ˌi p o ð ˈe p s u n
τυρί|t i r ˈi
τυφλούς|t i f l ˈu s
τυχερές|t ˌi ç e r ˈe s
τωόντι|t o ˈo d i
τό|t ˈo
τόλμη|t ˈo l m i
τόνο|t ˈo n o
τόξα|t ˈo k s a
τόξο|t ˈo k s o
τόπο|t ˈo p o
τόπος|t ˈo p o s
τόπου|t ˈo p u
τόρνο|t ˈo r n o
τόσα|t ˈo s a
τόσες|t ˈo s e s
τόσην|t ˈo s i n
τόσον|t ˈo s o n
τόσος|t ˈo s o s
τόσους|t ˈo s u s
τότε|t ˈo t e
τύλιγε|t ˈi l i j ˌe
τύλιξε|t ˈi l i k s ˌe
τύπος|t ˈi p o s
τύφλωνε|t ˈi f l o n ˌe
τύχει|t ˈi ç i
τώρα|t ˈo r a
υβριστικά|ˌi v r i s t i k ˈa
υγρασία|ˌi ɣ r a s ˈi  a
υιοθετεί|ˌi  o θ e t ˈi
υλικά|ˌi l i k ˈa
υλοτομία|ˌi l o t o m ˈi  a
υπάρχει|i p ˈa r ç i
υπάρχουν|i p ˈa r x u n
υπέρτατο|i p ˈe r t a t ˌo
υπαγόρευσε|ˌi p a ɣ ˈo r e f s ˌe
υπαλλήλους|ˌi p a l ˈi l u s
υπασπιστές|ˌi p a s p i s t ˈe s
υπασπιστή|ˌi p a s p i s t ˈi
υπασπιστής|ˌi p a s p i s t ˈi s
υπερήφανα|ˌi p e r ˈi f a n ˌa
υπερήφανο|ˌi p e r ˈi f a n ˌo
υπερασπίσει|ˌi p e r a s p ˈi s i
υπερηφάνεια|ˌi p e r i f ˈa ɲ a
υπηρέτες|ˌi p i r ˈe t e s
υπηρεσία|ˌi p i r e s ˈi  a
υπηρεσίας|ˌi p i r e s ˈi  a s
υπογραφή|ˌi p o ɣ r a f ˈi
υποδοχής|ˌi p o ð o ç ˈi s
υποκλίθηκε|ˌi p o k l ˈi θ i c ˌe
υποκλίθηκες|ˌi p o k l ˈi θ i c ˌe s
υποκλιθεί|ˌi p o k l i θ ˈi
υπολογιστή|ˌi p o l ˌo j i s t ˈi
υπομονετικά|ˌi p o m ˌo n e t i k ˈa
υποστηρίζεται|ˌi p o s t i r ˈi z e t ˌe
υποστράτηγο|ˌi p o s t r ˈa t i ɣ ˌo
υποστράτηγος|ˌi p o s t r ˈa t i ɣ ˌo s
υποσχέθηκα|ˌi p o s ç ˈe θ i k ˌa
υποχρέωσε|ˌi p o x r ˈe o s ˌe
υποχρεώνει|ˌi p o x r e ˈo n i
υποχρεώσει|ˌi p o x r e ˈo s i
υποχρεώσεις|ˌi p o x r e ˈo s i s
υποχωρούν|ˌi p o x o r ˈu n
υποψιάζουνταν|ˌi p o p s i  ˈa z u d ˌa n
υπό|i p ˈo
υπόγειο|i p ˈo j o
υπόκλιση|i p ˈo k l i s ˌi
υπόληψη|i p ˈo l i p s ˌi
υφάσματα|i f ˈa s m a t ˌa
υφασμένο|ˌi f a s m ˈe n o
φάγει|f ˈa j i
φάγουν|f ˈa ɣ u n
φάγω|f ˈa ɣ o
φάδωνε|f ˈa ð o n ˌe
φάει|f ˈa i
φάκελο|f ˈa c e l ˌo
φάμε|f ˈa m e
φάνε|f ˈa n e
φάνετε|f ˈa n e t ˌe
φάνηκαν|f ˈa n i k ˌa n
φάνηκε|f ˈa n i c ˌe
φάνουν|f ˈa n u n
φάρας|f ˈa r a s
φάρμακα|f ˈa r m a k ˌa
φέξει|f ˈe k s i
φέρει|f ˈe r i
φέρεις|f ˈe r i s
φέρετε|f ˈe r e t ˌe
φέρουν|f ˈe r u n
φέρτε|f ˈe r t e
φίλε|f ˈi l e
φίλησαν|f ˈi l i s ˌa n
φίλος|f ˈi l o s
φίλου|f ˈi l u
φίλους|f ˈi l u s
φαίνεσαι|f ˈe n e s ˌe
φαίνεται|f ˈe n e t ˌe
φαίνονται|f ˈe n o d ˌe
φαίνουνταν|f ˈe n u d ˌa n
φαγάκι|f a ɣ ˈa c i
φαγί|f a j ˈi
φαγιά|f a j ˈa
φαγωθούν|f ˌa ɣ o θ ˈu n
φαινόταν|f e n ˈo t a n
φαλάκρα|f a l ˈa k r a
φαμελίτες|f ˌa m e l ˈi t e s
φαμελική|f ˌa m e l i c ˈi
φαν|f ˈa n
φανάρι|f a n ˈa r i
φαναριού|f ˌa n a r i  ˈu
φανεί|f a n ˈi
φαντάζεσαι|f a d ˈa z e s ˌe
φανταζόμουν|f ˌa d a z ˈo m u n
φανταστικούς|f ˌa d a s t i k ˈu s
φανταχτερό|f ˌa d a x t e r ˈo
φανώ|f a n ˈo
φαρδείς|f a r ð ˈi s
φαρδιά|f ˌa r ð i  ˈa
φαρδύ|f a r ð ˈi
φαρδύς|f a r ð ˈi s
φας|f ˈa s
φελούκα|f e l ˈu k a
φελούκας|f e l ˈu k a s
φελούκες|f e l ˈu c e s
φερ'|f ˈe r
φερθώ|f e r θ ˈo
φευγαλέο|f ˌe v ɣ a l ˈe o
φευγιό|f e v j ˈo
φεύγει|f ˈe v j i
φεύγεις|f ˈe v j i s
φεύγετε|f ˈe v j e t ˌe
φεύγομε|f ˈe v ɣ o m ˌe
φεύγοντας|f ˈe v ɣ o d ˌa s
φεύγουν|f ˈe v ɣ u n
φθάνει|f θ ˈa n i
φθάνομε|f θ ˈa n o m ˌe
φθάνοντας|f θ ˈa n o d ˌa s
φθάνουν|f θ ˈa n u n
φθάσαμε|f θ ˈa s a m ˌe
φθάσει|f θ ˈa s i
φθάσεις|f θ ˈa s i s
φθάσετε|f θ ˈa s e t ˌe
φθάσομε|f θ ˈa s o m ˌe
φθάσω|f θ ˈa s o
φθόνο|f θ ˈo n o
φιλέψω|f i l ˈe p s o
φιλήθηκαν|f i l ˈi θ i k ˌa n
φιλήσει|f i l ˈi s i
φιλήσουν|f i l ˈi s u n
φιλία|f i l ˈi  a
φιλοξένησε|f ˌi l o k s ˈe n i s ˌe
φιλοξενήσουν|f ˌi l o k s e n ˈi s u n
φιλοξενία|f ˌi l o k s e n ˈi  a
φιλοτιμία|f ˌi l o t i m ˈi  a
φλέβες|f l ˈe v e s
φλαμούρι|f l a m ˈu r i
φλουριά|f l ˌu r i  ˈa
φλόγα|f l ˈo ɣ a
φλόγας|f l ˈo ɣ a s
φοβάσαι|f o v ˈa s e
φοβάστε|f o v ˈa s t e
φοβέρα|f o v ˈe r a
φοβέρας|f o v ˈe r a s
φοβέρες|f o v ˈe r e s
φοβέριζαν|f o v ˈe r i z ˌa n
φοβέρισε|f o v ˈe r i s ˌe
φοβήθηκε|f o v ˈi θ i c ˌe
φοβερά|f ˌo v e r ˈa
φοβερίζοντας|f ˌo v e r ˈi z o d ˌa s
φοβηθεί|f ˌo v i θ ˈi
φοβηθείς|f ˌo v i θ ˈi s
φοβισμένα|f ˌo v i s m ˈe n a
φοβισμένη|f ˌo v i s m ˈe n i
φοβισμένος|f ˌo v i s m ˈe n o s
φοβιτσιάρη|f ˌo v i ts i  ˈa r i
φοβούμαι|f o v ˈu m e
φοβούνται|f o v ˈu d e
φοβούνταν|f o v ˈu d a n
φοιτήτρια|f i t ˈi t r i  ˌa
φονιάδες|f o ɲ ˈa ð e s
φορά|f o r ˈa
φοράδα|f o r ˈa ð a
φορέματα|f o r ˈe m a t ˌa
φορές|f o r ˈe s
φορεί|f o r ˈi
φορείς|f o r ˈi s
φορεσιά|f ˌo r e s j ˈa
φορεσιάς|f ˌo r e s j ˈa s
φορούσε|f o r ˈu s e
φορτίο|f o r t ˈi  o
φορτωμένα|f ˌo r t o m ˈe n a
φορτωμένη|f ˌo r t o m ˈe n i
φορτωμένο|f ˌo r t o m ˈe n o
φορτωμένος|f ˌo r t o m ˈe n o s
φουντωμένο|f ˌu d o m ˈe n o
φουρκισμένη|f ˌu r c i s m ˈe n i
φουρκισμένος|f ˌu r c i s m ˈe n o s
φουρνέλο|f u r n ˈe l o
φουρτούνες|f u r t ˈu n e s
φουσκωμένο|f ˌu s k o m ˈe n o
φουστάνια|f u s t ˈa ɲ a
φούντωνε|f ˈu d o n ˌe
φούσκωνε|f ˈu s k o n ˌe
φούστα|f ˈu s t a
φούστας|f ˈu s t a s
φράουλες|f r ˈa u l ˌe s
φράση|f r ˈa s i
φρένιασε|f r ˈe ɲ a s ˌe
φρίκη|f r ˈi c i
φρίξεις|f r ˈi k s i s
φραγκιά|f r ˌa ŋ ɡ i  ˈa
φραουλιά|f r ˌa u ʎ ˈa
φραουλιάς|f r ˌa u ʎ ˈa s
φρενιασμένος|f r ˌe ɲ a s m ˈe n o s
φρενών|f r e n ˈo n
φριχτό|f r i x t ˈo
φρονησης|f r o n ˈi s i s
φροντίδα|f r o d ˈi ð a
φροντίζει|f r o d ˈi z i
φροντίζομε|f r o d ˈi z o m ˌe
φροντίσουν|f r o d ˈi s u n
φρουρά|f r u r ˈa
φρουραρχείο|f r ˌu r a r ç ˈi  o
φρουραρχείου|f r ˌu r a r ç ˈi  u
φρουρούς|f r u r ˈu s
φρούραρχο|f r ˈu r a r x ˌo
φρούραρχος|f r ˈu r a r x ˌo s
φρούραρχου|f r ˈu r a r x ˌu
φρούριο|f r ˈu r i  ˌo
φρούτα|f r ˈu t a
φρόνηση|f r ˈo n i s ˌi
φρόνησης|f r ˈo n i s ˌi s
φρόντιζαν|f r ˈo d i z ˌa n
φρόντιζε|f r ˈo d i z ˌe
φρόντισε|f r ˈo d i s ˌe
φρύδια|f r ˈi ð j a
φταίγει|f t ˈe j i
φταίει|f t ˈe i
φταις|f t ˈe s
φτερά|f t e r ˈa
φτερουγίζοντας|f t ˌe r u j ˈi z o d ˌa s
φτερούγιζαν|f t e r ˈu j i z ˌa n
φτες|f t ˈe s
φτιάνει|f t i  ˈa n i
φτιάνεις|f t i  ˈa n i s
φτιάνουν|f t i  ˈa n u n
φτιάσε|f t i  ˈa s e
φτιάσει|f t i  ˈa s i
φτιάσεις|f t i  ˈa s i s
φτιάσουν|f t i  ˈa s u n
φτιάσω|f t i  ˈa s o
φτωχικο|f t o ç ˈi k o
φτωχικού|f t ˌo ç i k ˈu
φτωχικό|f t ˌo ç i k ˈo
φτωχοί|f t o ç ˈi
φτωχολογιά|f t ˌo x o l o j ˈa
φτωχοντυμένο|f t ˌo x o d i m ˈe n o
φτωχούλη|f t o x ˈu l i
φτωχούλης|f t o x ˈu l i s
φτωχό|f t o x ˈo
φτωχόπαιδο|f t o x ˈo p e ð ˌo
φτωχός|f t o x ˈo s
φτύσομε|f t ˈi s o m ˌe
φτύσουμε|f t ˈi s u m ˌe
φτώχεια|f t ˈo ç a
φυγή|f i j ˈi
φυλάγει|f i l ˈa j i
φυλάγεις|f i l ˈa j i s
φυλάγοντας|f i l ˈa ɣ o d ˌa s
φυλάξεις|f i l ˈa k s i s
φυλάξουν|f i l ˈa k s u n
φυλαγμένο|f ˌi l a ɣ m ˈe n o
φυλακές|f ˌi l a c ˈe s
φυλακή|f ˌi l a c ˈi
φυλακής|f ˌi l a c ˈi s
φυλακισμένοι|f ˌi l a c i s m ˈe n i
φυλλάδα|f i l ˈa ð a
φυλλαράκι|f ˌi l a r ˈa c i
φυλλαράκια|f ˌi l a r ˈa c a
φυτέψουν|f i t ˈe p s u n
φυτρώνουν|f i t r ˈo n u n
φυτρώσει|f i t r ˈo s i
φυτό|f i t ˈo
φωλιά|f o ʎ ˈa
φωλιάζουν|f o ʎ ˈa z u n
φωλιές|f o ʎ ˈe s
φωνάζει|f o n ˈa z i
φωνάζετε|f o n ˈa z e t ˌe
φωνάζοντας|f o n ˈa z o d ˌa s
φωνάξει|f o n ˈa k s i
φωνάξεις|f o n ˈa k s i s
φωνάξετε|f o n ˈa k s e t ˌe
φωνάξομε|f o n ˈa k s o m ˌe
φωνάξουμε|f o n ˈa k s u m ˌe
φωνάξουν|f o n ˈa k s u n
φωνές|f o n ˈe s
φωνή|f o n ˈi
φωνήεντα|f o n ˈi  e d ˌa
φως|f ˈo s
φωτίζονται|f o t ˈi z o d ˌe
φωτεινά|f ˌo t i n ˈa
φωτεινή|f ˌo t i n ˈi
φωτιά|f ˌo t i  ˈa
φωτιά»|f ˌo t i  ˈa
φωτιάς|f ˌo t i  ˈa s
φωτισμένο|f ˌo t i s m ˈe n o
φόβο|f ˈo v o
φόβος|f ˈo v o s
φόβους|f ˈo v u s
φόνοι|f ˈo n i
φόρεμά|f ˈo r e m ˈa
φόρεμα|f ˈo r e m ˌa
φόρεσε|f ˈo r e s ˌe
φόρτωμα|f ˈo r t o m ˌa
φόρτωναν|f ˈo r t o n ˌa n
φόρτωσαν|f ˈo r t o s ˌa n
φόρτωσε|f ˈo r t o s ˌe
φύγαμε|f ˈi ɣ a m ˌe
φύγανε|f ˈi ɣ a n ˌe
φύγατε|f ˈi ɣ a t ˌe
φύγε|f ˈi j e
φύγει|f ˈi j i
φύγεις|f ˈi j i s
φύγομε|f ˈi ɣ o m ˌe
φύγουν|f ˈi ɣ u n
φύγω|f ˈi ɣ o
φύλαγαν|f ˈi l a ɣ ˌa n
φύλαγε|f ˈi l a j ˌe
φύλαξε|f ˈi l a k s ˌe
φύλλωμα|f ˈi l o m ˌa
φύση|f ˈi s i
φύσηξε|f ˈi s i k s ˌe
φύτεψε|f ˈi t e p s ˌe
φώνα|f ˈo n a
φώναζαν|f ˈo n a z ˌa n
φώναζε|f ˈo n a z ˌe
φώναξαν|f ˈo n a k s ˌa n
φώναξε|f ˈo n a k s ˌe
φώτιζε|f ˈo t i z ˌe
χάθηκαν|x ˈa θ i k ˌa n
χάθηκε|x ˈa θ i c ˌe
χάιδευε|x ˈaɪ ð e v ˌe
χάιδεψε|x ˈaɪ ð e p s ˌe
χάλια|x ˈa ʎ a
χάμω|x ˈa m o
χάνει|x ˈa n i
χάνεις|x ˈa n i s
χάνεται|x ˈa n e t ˌe
χάνετε|x ˈa n e t ˌe
χάνομε|x ˈa n o m ˌe
χάνοντας|x ˈa n o d ˌa s
χάνουνταν|x ˈa n u d ˌa n
χάντρες|x ˈa d r e s
χάραξε|x ˈa r a k s ˌe
χάρη|x ˈa r i
χάρισε|x ˈa r i s ˌe
χάρισμα|x ˈa r i s m ˌa
χάσει|x ˈa s i
χάσεις|x ˈa s i s
χάσομε|x ˈa s o m ˌe
χάσουμε|x ˈa s u m ˌe
χάσω|x ˈa s o
χέρι|ç ˈe r i
χέρια|ç ˈe r i  ˌa
χήνες|ç ˈi n e s
χία|ç ˈi  a
χίλιες|ç ˈi ʎ e s
χαίρονταν|ç ˈe r o d ˌa n
χαίρουνταν|ç ˈe r u d ˌa n
χαδιάρικα|x ˌa ð i  ˈa r i k ˌa
χαθεί|x a θ ˈi
χαιρέτησαν|ç e r ˈe t i s ˌa n
χαιρέτησε|ç e r ˈe t i s ˌe
χαιρετά|ç ˌe r e t ˈa
χαιρετήσετε|ç ˌe r e t ˈi s e t ˌe
χαιρετήσουν|ç ˌe r e t ˈi s u n
χαιρετίσματα|ç ˌe r e t ˈi s m a t ˌa
χαιρετισμό|ç ˌe r e t i s m ˈo
χαιρετώντας|ç ˌe r e t ˈo d a s
χαλάζι|x a l ˈa z i
χαλάρωσε|x a l ˈa r o s ˌe
χαλάσεις|x a l ˈa s i s
χαλάσματα|x a l ˈa s m a t ˌa
χαλάσω|x a l ˈa s o
χαλί|x a l ˈi
χαμένα|x a m ˈe n a
χαμένη|x a m ˈe n i
χαμένο|x a m ˈe n o
χαμηλή|x ˌa m i l ˈi
χαμηλοπετούσε|x ˌa m i l ˌo p e t ˈu s e
χαμηλότερα|x ˌa m i l ˈo t e r ˌa
χαμηλόφωνα|x ˌa m i l ˈo f o n ˌa
χαμογέλασαν|x ˌa m o j ˈe l a s ˌa n
χαμογέλασε|x ˌa m o j ˈe l a s ˌe
χαμογελούσε|x ˌa m o j e l ˈu s e
χαμογελώντας|x ˌa m o j e l ˈo d a s
χαμόδεντρα|x a m ˈo ð e d r ˌa
χαμόκλαδα|x a m ˈo k l a ð ˌa
χαντάκια|x a d ˈa c a
χαρά|x a r ˈa
χαρές|x a r ˈe s
χαρίζει|x a r ˈi z i
χαρίσει|x a r ˈi s i
χαρίσω|x a r ˈi s o
χαρακτήρα|x ˌa r a k t ˈi r a
χαρανί|x ˌa r a n ˈi
χαρείς|x a r ˈi s
χαριστής|x ˌa r i s t ˈi s
χαρούμενα|x a r ˈu m e n ˌa
χαρούμενη|x a r ˈu m e n ˌi
χαρούμενο|x a r ˈu m e n ˌo
χαρούμενος|x a r ˈu m e n ˌo s
χαρτάκια|x a r t ˈa c a
χαρτί|x a r t ˈi
χαρτιά|x ˌa r t i  ˈa
χαρώ|x a r ˈo
χειμώνα|ç i m ˈo n a
χειμώνας|ç i m ˈo n a s
χειράμαξα|ç i r ˈa m a k s ˌa
χειρονομίες|ç ˌi r o n o m ˈi  e s
χειρότερα|ç i r ˈo t e r ˌa
χειρότεροι|ç i r ˈo t e r ˌi
χειρότερος|ç i r ˈo t e r ˌo s
χειρότερους|ç i r ˈo t e r ˌu s
χεράκια|ç e r ˈa c a
χεριού|ç ˌe r i  ˈu
χημειοθεραπεία|ç ˌi m ç o θ ˌe r a p ˈi  a
χθες|x θ ˈe s
χιλίαρχος|ç i l ˈi  a r x ˌo s
χιλιάδες|ç i ʎ ˈa ð e s
χιονοσκέπαστο|ç ˌo n o s c ˈe p a s t ˌo
χιόνια|ç ˈo ɲ a
χλωμιάσει|x l ˌo m i  ˈa s i
χλωμοί|x l o m ˈi
χλωμό|x l o m ˈo
χλωμός|x l o m ˈo s
χλώμιασε|x l ˈo m i  ˌa s e
χμ|ç ˌi m ˈi
χολόσκανε|x o l ˈo s k a n ˌe
χοντρά|x o d r ˈa
χοντροί|x o d r ˈi
χοντροκοπιούς|x ˌo d r o k o p ç ˈu s
χοντροπελεκημένο|x ˌo d r o p ˌe l e c i m ˈe n o
χοντρό|x o d r ˈo
χοντρός|x o d r ˈo s
χορέψει|x o r ˈe p s i
χοροπηδούσαν|x ˌo r o p i ð ˈu s a n
χοροπηδούσε|x ˌo r o p i ð ˈu s e
χορούς|x o r ˈu s
χορτάρι|x o r t ˈa r i
χορτάρια|x o r t ˈa r i  ˌa
χορτάσεις|x o r t ˈa s i s
χορταρικά|x ˌo r t a r i k ˈa
χρέος|x r ˈe o s
χρήματα|x r ˈi m a t ˌa
χρήση|x r ˈi s i
χρήσιμος|x r ˈi s i m ˌo s
χρειάζονται|x r ç ˈa z o d ˌe
χρειάζουνταν|x r ç ˈa z u d ˌa n
χρειάστηκαν|x r ç ˈa s t i k ˌa n
χρειαζόμαστε|x r ç a z ˈo m a s t ˌe
χρειαζόταν|x r ç a z ˈo t a n
χρειαστεί|x r ç a s t ˈi
χρειαστείς|x r ç a s t ˈi s
χρησιμεύουν|x r ˌi s i m ˈe v u n
χρησιμεύσει|x r ˌi s i m ˈe f s i
χρησιμεύσουν|x r ˌi s i m ˈe f s u n
χρησιμοποιήσει|x r ˌi s i m ˌo p i  ˈi s i
χρυσά|x r i s ˈa
χρυσές|x r i s ˈe s
χρυσή|x r i s ˈi
χρυσής|x r i s ˈi s
χρυσοκέντητα|x r ˌi s o c ˈe d i t ˌa
χρυσοκέντητο|x r ˌi s o c ˈe d i t ˌo
χρυσοϋφασμένη|x r ˌi s o ˌi f a s m ˈe n i
χρυσό|x r i s ˈo
χρό|x r ˈo
χρόνο|x r ˈo n o
χρόνων|x r ˈo n o n
χτένι|x t ˈe n i
χτίζει|x t ˈi z i
χτίζουν|x t ˈi z u n
χτίζουνταν|x t ˈi z u d ˌa n
χτίριο|x t ˈi r i  ˌo
χτίσει|x t ˈi s i
χτίσεις|x t ˈi s i s
χτίσουν|x t ˈi s u n
χτίστες|x t ˈi s t e s
χτίστηκαν|x t ˈi s t i k ˌa n
χτίσω|x t ˈi s o
χτισμένο|x t i s m ˈe n o
χτυπά|x t i p ˈa
χτυπάει|x t i p ˈa i
χτυπήματα|x t i p ˈi m a t ˌa
χτυπήσει|x t i p ˈi s i
χτυπήσομε|x t i p ˈi s o m ˌe
χτυπιούνταν|x t i p ç ˈu d a n
χτυπούν|x t i p ˈu n
χτυπούσε|x t i p ˈu s e
χτυπώντας|x t i p ˈo d a s
χτύπησαν|x t ˈi p i s ˌa n
χτύπησε|x t ˈi p i s ˌe
χτύπησες|x t ˈi p i s ˌe s
χυδαίοι|ç i ð ˈe i
χωμένα|x o m ˈe n a
χωνέψει|x o n ˈe p s i
χωνί|x o n ˈi
χωράφια|x o r ˈa f i  ˌa
χωρίς|x o r ˈi s
χωρίσει|x o r ˈi s i
χωρίστηκαν|x o r ˈi s t i k ˌa n
χωρατά|x ˌo r a t ˈa
χωρατεύω|x ˌo r a t ˈe v o
χωρεί|x o r ˈi
χωριά|x ˌo r i  ˈa
χωριάτισσες|x ˌo r i  ˈa t i s s ˌe s
χωρικοί|x ˌo r i c ˈi
χωρικού|x ˌo r i k ˈu
χωρικούς|x ˌo r i k ˈu s
χωριουδάκι|x ˌo r i  u ð ˈa c i
χωρισμένα|x ˌo r i s m ˈe n a
χωριό|x ˌo r i  ˈo
χωροφυλακας|x ˌo r o f i l ˈa k a s
χωροφύλακας|x ˌo r o f ˈi l a k ˌa s
χωροφύλακες|x ˌo r o f ˈi l a c ˌe s
χωρούσαν|x o r ˈu s a n
χωρούσε|x o r ˈu s e
χόλιασε|x ˈo ʎ a s ˌe
χόρτα|x ˈo r t a
χόρτο|x ˈo r t o
χύθηκαν|ç ˈi θ i k ˌa n
χύθηκε|ç ˈi θ i c ˌe
χώθηκε|x ˈo θ i c ˌe
χώματα|x ˈo m a t ˌa
χώνουνταν|x ˈo n u d ˌa n
χώνω|x ˈo n o
χώρα|x ˈo r a
χώρας|x ˈo r a s
χώρες|x ˈo r e s
χώριζαν|x ˈo r i z ˌa n
χώριζε|x ˈo r i z ˌe
χώρισε|x ˈo r i s ˌe
χώρο|x ˈo r o
χώσεις|x ˈo s i s
χώσω|x ˈo s o
ψάρια|p s ˈa r i  ˌa
ψέλλισε|p s ˈe l i s ˌe
ψέματα|p s ˈe m a t ˌa
ψήνει|p s ˈi n i
ψήσε|p s ˈi s e
ψήσουν|p s ˈi s u n
ψήσω|p s ˈi s o
ψαρά|p s a r ˈa
ψεύτη|p s ˈe f t i
ψηθεί|p s i θ ˈi
ψηλά|p s i l ˈa
ψηλής|p s i l ˈi s
ψηλό|p s i l ˈo
ψηλός|p s i l ˈo s
ψηλότερα|p s i l ˈo t e r ˌa
ψημένες|p s i m ˈe n e s
ψηφία|p s i f ˈi  a
ψιθυρίσματα|p s ˌi θ i r ˈi s m a t ˌa
ψιθύρισε|p s i θ ˈi r i s ˌe
ψουν|p s ˈu n
ψοφήσουν|p s o f ˈi s u n
ψυχή|p s i ç ˈi
ψυχής|p s i ç ˈi s
ψώρα|p s ˈo r a
ωρίμασαν|o r ˈi m a s ˌa n
ωραία|o r ˈe a
ωραίο|o r ˈe o
ωριμάζανε|ˌo r i m ˈa z a n ˌe
ωριμάζει|ˌo r i m ˈa z i
ωρολόγι|ˌo r o l ˈo j i
ως|ˈo s
ωφέλεια|o f ˈe ʎ a
ωφελήσει|ˌo f e l ˈi s i
ωφεληθεί|ˌo f e l i θ ˈi
ωφεληθείς|ˌo f e l i θ ˈi s
ωφεληθείς»|ˌo f e l i θ ˈi s
ωχ|ˈo x
ό|ˌo m i k r o n t ˈo n o s
όλ'|ˈo l
όλα|ˈo l a
όλες|ˈo l e s
όλη|ˈo l i
όλην|ˈo l i n
όλοι|ˈo l i
όλον|ˈo l o n
όλος|ˈo l o s
όλου|ˈo l u
όλους|ˈo l u s
όλων|ˈo l o n
όμοιους|ˈo m i  ˌu s
όμορφα|ˈo m o r f ˌa
όμορφος|ˈo m o r f ˌo s
όμως|ˈo m o s
όνειρο|ˈo n i r ˌo
όνομα|ˈo n o m ˌa
όντως|ˈo d o s
όπλα|ˈo p l a
όπλο|ˈo p l o
όποιον|ˈo p i  ˌo n
όποιος|ˈo p i  ˌo s
όπου|ˈo p u
όπως|ˈo p o s
όργωναν|ˈo r ɣ o n ˌa n
όρθια|ˈo r θ i  ˌa
όρθιο|ˈo r θ i  ˌo
όρθιου|ˈo r θ i  ˌu
όρκο|ˈo r k o
όρκους|ˈo r k u s
όρμησαν|ˈo r m i s ˌa n
όρμησε|ˈo r m i s ˌe
όρνια|ˈo r ɲ a
όσα|ˈo s a
όσες|ˈo s e s
όση|ˈo s i
όσο|ˈo s o
όσοι|ˈo s i
όσους|ˈo s u s
όταν|ˈo t a n
ότι|ˈo t i
όφελος|ˈo f e l ˌo s
όχημα|ˈo ç i m ˌa
όχθες|ˈo x θ e s
όχθη|ˈo x θ i
όχθης|ˈo x θ i s
όχι|ˈo ç i
όψη|ˈo p s i
ύπαρξής|ˈi p a r k s ˈi s
ύπαρξη|ˈi p a r k s ˌi
ύπνο|ˈi p n o
ύπνος|ˈi p n o s
ύπνου|ˈi p n u
ύφος|ˈi f o s
ώμο|ˈo m o
ώμοι|ˈo m i
ώμου|ˈo m u
ώμους|ˈo m u s
ώραν|ˈo r a n
ώρες|ˈo r e s