'|'
a|Error: The specified espeak-ng voice does not exist.
backbone|Error: The specified espeak-ng voice does not exist.
demo|Error: The specified espeak-ng voice does not exist.
experiment|Error: The specified espeak-ng voice does not exist.
first|Error: The specified espeak-ng voice does not exist.
for|Error: The specified espeak-ng voice does not exist.
is|Error: The specified espeak-ng voice does not exist.
johanna|johannaʔ
line|Error: The specified espeak-ng voice does not exist.
new|Error: The specified espeak-ng voice does not exist.
sentence|Error: The specified espeak-ng voice does not exist.
speech|Error: The specified espeak-ng voice does not exist.
text|Error: The specified espeak-ng voice does not exist.
the|Error: The specified espeak-ng voice does not exist.
this|Error: The specified espeak-ng voice does not exist.
three|Error: The specified espeak-ng voice does not exist.
to|Error: The specified espeak-ng voice does not exist.
vee|Error: The specified espeak-ng voice does not exist.
very|Error: The specified espeak-ng voice does not exist.
with|Error: The specified espeak-ng voice does not exist.
xvasynth|xvasynth
กรณีรัฐใช้ความรุนแรงละเมิดสิทธิผู้ชุมนุม|konniːratt͡ɕʰajkʰwaːmrunarɛːŋlamɤtsitʰatʰipʰuːt͡ɕʰumnum
กระทำการกระจายเสียงหรือกระจายภาพ|kratʰaำkaːnkrat͡ɕaːjsiːa̯ŋohrɯːɔːkrat͡ɕaːjpʰaːp
กระโดดลงไปในแอ่งน้ำ|kradoːtlaŋapajnajʔɛːŋnaำ
กรุงเทพในฝัน|kruŋtʰeːpʰanajfan
กลินดาเขาอาจจะแนะนำ|klindaːkʰeːaːʔaːtt͡ɕanɛnaำ
กลุ่มนักพัฒนาหุ่นยนต์พูดคุยเกี่ยวกับการพยายามขัดขวางทางภูมิศาสตร์เพื่อความร่วมมือกัน|klumnakapʰatnaːhunjanapʰuːtkʰujakiːa̯wkabakaːnpʰajaːjaːmkʰadokwaːŋatʰaːŋpʰuːmisaːttapʰɯːa̯kwaːmonwamamɯːɔːkan
กลุ่มผู้ก่อการร้ายทำตามเป้าหมายที่ตั้งไว้|klumpʰuːkɔːkaːnraːjatʰaำtaːmpeːaːhmaːjatʰiːtaŋwaj
กลุ่มวัยรุ่นบุกเข้าไปในรถขุดเมื่อคืนนี้และพังสถานที่นั้น|klumwajarunbukakʰeːaːpajnajrotkʰudamɯːa̯kʰɯːnniːlɛpʰaŋsatʰaːntʰiːnan
กษัตริย์บาห์เรน|kasatribaːreːn
กษัตริย์พูด|kasatripʰuːt
กัญชง|kajt͡ɕʰoŋ
กับคุณ|kabkʰun
กับฉันเนี่ยนะ|kabt͡ɕʰananiːa̯naʔ
กางเกงพวกนี้ไม่พอดีตัว|kaːŋkeːŋopwakaniːmajpʰɔːdiːtuːa̯
การขยับของเธอ|kaːnkʰajabkʰɔːŋatʰɤː
การขายวัตถุมงคล|kaːnkʰaːjawattʰumoŋkʰon
การขี่จักรยานไปบนถนนที่เต็มไปด้วยหินเป็นเรื่องยาก|kaːnkʰiːt͡ɕakrajaːnpajbontʰanontʰiːteːmpajdowjahinpeːnarɯːa̯ŋjaːk
การจัดวางจานบนโต๊ะเป็นเรื่องง่าย|kaːnt͡ɕadawaːŋt͡ɕaːnobnatopeːnrɯːa̯ŋaŋaːj
การจำนองแพงมากกว่าเพราะว่าผู้คนต้องจ่ายดอกเบี้ยยาวนานกว่า|kaːnt͡ɕaำnɔːŋpʰɛːŋamaːkkwaːpʰeːraːawaːpʰuːknatɔːŋt͡ɕaːjadɔːkbiːa̯jaːwnaːnokwaː
การบันทึกของเธอไม่สมบูรณ์|kaːnbanatʰɯkkʰɔːŋatʰɤːmajsombuːn
การบันทึกนี้ถูกทำให้เสียหาย|kaːnbanatʰɯkniːtʰuːktʰaำhajsiːa̯haːj
การพ่ายแพ้|kaːnpʰaːjapʰɛː
การมี|kaːnmiː
การรีวิวค่าเฉลี่ยถึงน่ารังเกียจกว่าน้ำมันตับปลา|kaːnriːwiwkʰaːt͡ɕʰeːliːjtʰɯŋanaːraŋkiːa̯t͡ɕokwaːnaำmantaboplaː
การสร้างรหัสหรือแฮชเพื่อแสดงเอฟเฟกต์หิมะถล่มเป็นหนึ่งในวัตถุประสงค์การออกแบบหลัก|kaːnsaraːŋrahatharɯːɔːhɛːtpʰɯːa̯sɛːtŋaʔeːffeːkahimatlamapeːnhanɯŋnajwattʰupratŋakaːnʔɔːkabɛːbhalak
การสูญเสียเหล่านี้สามารถลดลงได้โดยการใช้ช่องแบบคู่ขนาน|kaːnsuːjasiːa̯heːlaːniːsaːmaːntʰalotlaŋadajdoːjkaːrat͡ɕʰajt͡ɕʰɔːŋbɛːbakʰuːknaːn
การเดินทางอย่างไร้จุดหมายของยิว|kaːndɤnatʰaːŋɔːjaːŋrajt͡ɕuthamaːjkʰɔːŋajiw
การเรียนรู้เกี่ยวกับวัคซีนตัวใหม่ของคลินิกยังคงดีเยี่ยม|kaːnriːa̯naruːkiːa̯wkabawaksiːnatuːa̯hajmakʰɔːŋkʰlinikjaŋokŋadiːjiːa̯m
กินข้าวดีกว่า|kinkʰaːwadiːkwaː
ก็คืออาจจะได้ผลลัพธ์ที่ดีจากการเรียนคณิตศาสตร์|ka็kʰɯːʔɔːaːtt͡ɕadajpʰonlapʰatʰiːdiːt͡ɕaːkkaːrariːa̯nkʰanitsaːsot
ก็จริง|ka็t͡ɕariŋ
ก็จะได้บริการดีเป็นพิเศษ|ka็t͡ɕadajbarikaːndiːpeːnpʰiseːt
ก็พังด้วยประการฉะนี้|ka็pʰaŋdawojprakaːnt͡ɕʰaniː
ก็มาจากรัฐแหละ|ka็maːt͡ɕaːkratʰahɛːlaʔ
ก็รัฐประหาร|ka็ratprahaːn
ก็เกิดผลดีได้นะ|ka็kɤtpʰladiːdajnaʔ
ก็ไม่ทิ้งความเชื่อของตัวเอง|ka็majtʰiŋkʰwaːmt͡ɕʰɯːa̯kʰɔːŋtuːa̯ʔeːŋ
ก่อนที่อสิซจะพูดอะไร|kɔːntʰiːɔːsitt͡ɕapʰuːtʔaraj
ก่อนเริ่มต้นเดือนมกราคม|kɔːnrɤmotnadɯːa̯nmokraːkʰom
ขณะเดียวกันก็ดูแคลนความวุ่นวาย|kʰanadiːa̯wkanaka็duːkʰɛːnnokʰwaːmwunawaːj
ขบคิด|kʰobkʰit
ขอขอบคุณ|kʰɔːkʰɔːbkʰun
ของกินเมืองย่าโม|kʰɔːŋkinamɯːa̯ŋjaːmoː
ของฉัน|kʰɔːŋt͡ɕʰan
ของฉันรู้สึกหลาบจำหลังจากทำสิ่งผิดพลาดในวันนี้|kʰɔːŋt͡ɕʰanaruːsɯkhalaːbt͡ɕaำhalaŋt͡ɕaːkatʰaำsiŋpʰidoplaːdanajwanniː
ขอบคุณที่เข้าใจ|kʰɔːbkʰunatʰiːkʰeːaːt͡ɕaj
ขอบคุณนะครับ|kʰɔːbkʰunanakrab
ขอสั่งแฟลตไวท์ค่ะ|kʰɔːsaŋfɛːlotwajkʰaʔ
ขอโทษด้วยนะตารางฉันเต็มไปจนถึงอาทิตย์หน้าเลย|kʰɔːtʰoːtdawojnataːraːŋt͡ɕʰanateːmpajt͡ɕontʰɯŋaʔaːtʰithanaːleːj
ขอให้หายเซ็งเร็วเร็ว|kʰɔːhajhaːjseːŋareːwreːw
ขอให้เป็นการเดินทางที่ดี|kʰɔːhajpeːnkaːradɤntʰaːŋatʰiːdiː
ข้อมูลบันทึกแสดงให้เห็นว่าไม่มีใครเคยอ่านข้อตกลงลิขสิทธิ์ซอฟต์แวร์ระหว่างการติดตั้ง|kʰɔːmuːnbanatʰɯksɛːdoŋhajheːnwaːmajmiːkʰajrakʰeːjʔaːnakʰɔːtkloŋlikʰasittʰasɔːfwɛːrahwaːŋakaːntidataŋ
คนขายเนื้อให้แฮมฟรีหนึ่งกิโลกรัม|kʰonkʰaːjanɯːa̯hajhɛːmfariːhnɯŋakiloːkram
คนตัดต้นไม้กระโดดขึ้นไปบนต้นไม้|kʰontadotnamajkradoːtkʰɯnapajbontanamaj
คนตายเพราะไฟไหม้เยอะ|kʰontaːjapʰeːraːafajhajmajeːʔaʔ
คนที่รายงานสภาพโรงแรมแมลงสาบ|kʰontʰiːraːjŋaːnotpʰaːpʰroːŋrɛːmamɛːnŋasaːb
คนไทยจงอย่าใจแคบกับสถาบันกษัตริย์|kʰontʰajt͡ɕaŋɔːjaːt͡ɕajkʰɛːbkabottʰaːbankasatriʔ
คนไม่ได้สนใจมากนัก|kʰonmajdajsont͡ɕajmaːknak
ครอบครัวของพวกเขาอาศัยอยู่ที่นี่จากรุ่นสู่รุ่น|kʰrɔːbkʰruːa̯kʰɔːŋpʰawokkʰeːaːʔaːsajɔːjuːtʰiːniːt͡ɕaːkrunasuːrun
ครั้งหนึ่งผมเคยเป็นเด็กบ้านนอกของแท้เลย|kʰraŋhanɯŋpʰamakʰeːjpeːnadeːkbaːnanɔːkkʰɔːŋatʰɛːleːj
ครูของฉันจะโยนชอล์คกับยางลบมาใส่ฉันเวลาลืมเข็มขัด|kʰruːkʰɔːŋt͡ɕʰanat͡ɕajoːnt͡ɕʰɔːkʰakabjaːŋonbamaːsajt͡ɕʰanweːlaːlɯːmkʰeːmakʰat
ควรย้ายไปที่อื่น|kʰwrajaːjpajtʰiːʔɯːn
ความกลัวทั้งหลายก็ถาโถมเข้าใส่เธอ|kʰwaːmkluːa̯tʰaŋhalaːjka็tʰaːtʰoːmkʰeːaːsajtʰɤː
ความจริงจะปรากฎในไม่ช้า|kʰwaːmt͡ɕariŋt͡ɕapraːkdanajmajt͡ɕʰaː
ความฉลาดของมนุษย์มันช่างยากเกินกว่าเครื่องจักรจะเลียนแบบได้|kʰwaːmt͡ɕʰalaːtkʰɔːŋomnusamant͡ɕʰaːŋajaːkkɤnokwaːkʰeːrɯːɔːŋt͡ɕakont͡ɕaliːa̯nbɛːbadaj
ความชัดเจนของราคาในเมนู|kʰwaːmt͡ɕʰadat͡ɕeːnkʰɔːŋaraːkʰaːnajmeːnuː
ความรู้คือสิ่งที่ล้ำค่า|kʰwaːmruːkʰɯːɔːsiŋtʰiːlaำkʰaː
ความหมายของเครื่องหมายดอกจันในคำพูดธรรมดาคืออะไร|kʰwaːmhamaːjkʰɔːŋakʰeːrɯːɔːŋhamaːjdɔːkat͡ɕannajkʰaำpʰuːttʰronmadaːkʰɯːʔɔːaraj
ความเงียบจะให้ความยินยอม|kʰwaːmŋiːa̯bat͡ɕahajkʰwaːmjinajɔːm
ความเพิกเฉยคือความสุข|kʰwaːmpʰɤkat͡ɕʰeːjkʰɯːɔːkwaːmasuk
ความไว้ใจที่ได้มาจากการโกหกนั้น|kʰwaːmwajt͡ɕajtʰiːdajmaːt͡ɕaːkkaːrakoːhkanan
คำหวานใช้งานได้ดีกว่าดุร้าย|kʰaำhawaːnt͡ɕʰajŋaːndajdiːkwaːduraːj
คีย์เวิร์ดต่อไป|kʰiːwɤttɔːpaj
คือคนที่อยากเห็นพืชพันธุ์งอกงามโดยไม่พรวนดินก่อน|kʰɯːɔːknatʰiːɔːjaːkheːnapʰɯːtpʰanotŋɔːkaŋaːmdoːjamajpʰonwanadinkɔːn
คือถ้าผิดตั้งแต่ตอนส่งก็จบ|kʰɯːɔːtʰaːpʰittaŋatɛːtɔːnsaŋaka็t͡ɕob
คือสังคมที่มีความหลากหลาย|kʰɯːɔːsaŋkʰamatʰiːmiːkwaːmohlaːkohlaːj
คือได้ยินบ่อยมาก|kʰɯːɔːdajinbɔːjamaːk
คุณกรอกลับเทปคาสเซทหรือไม่|kʰunkrɔːklabatʰeːpkʰaːsaseːtharɯːɔːmaj
คุณก็ฉุน|kʰunka็t͡ɕʰun
คุณก็รู้ว่าฉันไม่ได้บอกว่าเป็นฉัน|kʰunka็ruːwaːt͡ɕʰanmajdajbɔːkwaːpeːnt͡ɕʰan
คุณคิดยังไงกับเรื่องนี้|kʰunkʰidajaŋŋajkabrɯːa̯ŋaniː
คุณคิดยังไงโรซ่าที่คุณเป็นความปลอดภัยหรือความสบายใจของฉัน|kʰunkʰidajaŋŋajroːsaːtʰiːkʰunpeːnokwaːmoplɔːdapʰajharɯːɔːkwaːmotbaːjat͡ɕajkʰɔːŋt͡ɕʰan
คุณจะปกป้องพวกเขาอย่างไร|kʰunt͡ɕapokpɔːŋopwakakʰeːaːɔːjaːŋraj
คุณจะเห็นหม้อ|kʰunt͡ɕaheːnhamɔː
คุณจะเอาจดหมายพวกนั้นมาด้วยก็ได้|kʰunt͡ɕaʔeːaːtdahamaːjpʰawoknanamaːtwajaka็daj
คุณจะไม่มีวันได้ยินข่าวดีเกี่ยวกับเธอ|kʰunt͡ɕamajmiːwandajinkʰaːwadiːkiːa̯wkabatʰɤː
คุณจำรถและหมายเลขของมันได้|kʰunt͡ɕaำrotlɛhamaːjleːkʰakʰɔːŋmanadaj
คุณชนะแล้ว|kʰunt͡ɕʰanalɛːw
คุณชอบผ่อนคลายอย่างไรหลังเลิกงาน|kʰunt͡ɕʰɔːbapʰɔːnkʰlaːjɔːjaːŋrajhalaŋlɤkaŋaːn
คุณต้องช่วยฉัน|kʰuntɔːŋotwajat͡ɕʰan
คุณถามฉันหรือเปล่าว่ามันคืออะไร|kʰuntʰaːmat͡ɕʰanharɯːɔːpeːlaːwaːmankʰɯːʔɔːaraj
คุณทอมสัน|kʰuntʰɔːmasan
คุณทำมันขึ้นมาจากอะไร|kʰuntʰaำmankʰɯnamaːt͡ɕaːkʔaraj
คุณผู้หญิงเหมือนเด็กเล็ก|kʰunpʰuːhajiŋheːmɯːɔːndeːkleːk
คุณรู้ว่าฉันพูดถึงอะไร|kʰunruːwaːt͡ɕʰanpʰuːdatʰɯŋʔaraj
คุณรู้สึกว่าวันหยุดยาวมันช่างยาวมากเกินไป|kʰunruːsɯkwaːwanhajutjaːwamant͡ɕʰaːŋajaːwmaːkakɤnpaj
คุณรู้หรือไม่ว่าพวกเขาจะปิดในเดือนมกราคม|kʰunruːharɯːɔːmajwaːpwakakʰeːaːt͡ɕapitnajdɯːa̯nmokraːkʰom
คุณรู้ได้อย่างไรว่าเธอก็ไม่ได้กระหายน้ำด้วย|kʰunruːdajɔːjaːŋrajwaːtʰɤːka็majdajkrahaːjnaำdawoj
คุณลุงท่านชอบดนตรีไทย|kʰunluŋatʰaːnt͡ɕʰɔːbotnotriːtʰaj
คุณหมอของฉันบอกว่าให้ทานยาพวกนี้ก่อนทานอาหาร|kʰunhamɔːkʰɔːŋt͡ɕʰanabɔːkwaːhajtʰaːnjaːpʰowkaniːkɔːntʰaːnaʔaːhaːn
คุณอยากห้ามฉันที่จะใช้ชื่อจริง|kʰunɔːjaːkhaːmat͡ɕʰantʰiːt͡ɕat͡ɕʰajt͡ɕʰɯːɔːtriŋ
คุณฮีตคลิฟฟ์อยู่ที่นั่น|kʰunhiːtoklifɔːjuːtʰiːnan
คุณเคยได้รับเงินจากความอุตสาหะของคุณเองหรือไม่|kʰunkʰeːjadajrabŋɤnat͡ɕaːkkʰwaːmʔutasaːhakʰɔːŋkʰunaʔeːŋharɯːɔːmaj
คุณเดินวันละกี่นาที|kʰundɤnawanlakiːnaːtʰiː
คุณเตือนฉัน|kʰuntɯːa̯nat͡ɕʰan
คุณเหนื่อยแล้ว|kʰunheːnɯːɔːjlɛːw
คุณเห็นมัน|kʰunheːnaman
คุณเห็นว่าอย่างไร|kʰunheːnawaːɔːjaːŋraj
คุณเอาน้ำไปแช่แข็งเพื่อให้ได้น้ำแข็งที่สะอาด|kʰunʔeːaːnaำpajt͡ɕʰɛːkʰɛː็ŋapʰɯːa̯hajdajnaำkʰɛː็ŋatʰiːsaʔaːt
คุณแม่ของพวกเขานั่งเย็บผ้าด้านล่าง|kʰunmɛːkʰɔːŋpʰawokkʰeːaːnaŋjeːbapʰaːdaːnlaːŋ
คุณแม่จะไปตลาดหรือคะ|kʰunmɛːt͡ɕapajtalaːtharɯːɔːkʰaʔ
คุณแองเจล่าพูดถูกครับ|kʰunʔɛːŋat͡ɕeːlaːpʰuːttʰuːkokrab
คุณไม่ได้ตั้งค่าตัวบ่งชี้ก่อนออกจากวงเวียน|kʰunmajdajtaŋkʰaːtuːa̯bŋat͡ɕʰiːkɔːnʔɔːkat͡ɕaːkwaŋawiːa̯n
ค่ายพหลโยธิน|kʰaːjpʰahonjoːtʰin
จงคิดตามไปเอาไม้เท้าเถิด|t͡ɕoŋkʰidataːmpajʔeːaːmajtʰeːaːtʰɤt
จงเชื่อในสิ่งที่เห็นมากกว่าสิ่งที่ชวนเชื่อ|t͡ɕoŋt͡ɕʰɯːa̯najsiŋtʰiːheːnmaːkokwaːsiŋtʰiːt͡ɕʰownat͡ɕʰɯːa̯
จนกระทั่งการปรากฏตัวอย่างกระทันหันของเขา|t͡ɕonkratʰaŋkaːropraːkottuːa̯ɔːjaːŋkratʰanhanakʰɔːŋkʰeːaː
จนกว่าพอใจ|t͡ɕonkwaːpʰɔːt͡ɕaj
จบลง|t͡ɕobloŋ
จบแล้วจริง|t͡ɕoblɛːwotriŋ
จริงและแท้จริง|t͡ɕariŋlɛtʰɛːtriŋ
จอห์นและเจมส์แข่งขันในการแข่งขัน|t͡ɕɔːnlɛt͡ɕeːmkʰɛːŋakʰannajkaːnkʰɛːŋakʰan
จะขอรวบรวมส่งต่อเข้าห้องหลังจบการแสดงความคิดเห็นรอบสองนี้นะครับ|t͡ɕakʰɔːnwabonwamotŋatɔːkʰeːaːhɔːŋhalaŋt͡ɕabakaːnsɛːdoŋkʰwaːmkʰidaheːnrɔːbasɔːŋniːnakrab
จะตรวจสอบอย่างแน่นอน|t͡ɕatrawotsɔːbɔːjaːŋnɛːnɔːn
จะต้องไม่มีการรัฐประหารและการจัดตั้งรัฐบาลแห่งชาติ|t͡ɕatɔːŋmajmiːkaːnratʰoprahaːnlɛkaːnt͡ɕadataŋratʰabaːnhɛːŋat͡ɕʰaːtiʔ
จะประเสริฐสมรักเป็นศักดิ์ศรี|t͡ɕapraseːritsamarakpeːnasakdasariː
จะเป็นผู้ยิ่งใหญ่มาก|t͡ɕapeːnpʰuːjiŋhajjamaːk
จะใคร่ลงเรือใบ|t͡ɕakʰajronŋarɯːa̯baj
จัดตั้งจังหวัดพะเยา|t͡ɕattaŋat͡ɕaŋhawatpʰajeːaː
จัดตั้งจังหวัดมุกดาหาร|t͡ɕattaŋat͡ɕaŋhawatmukadaːhaːn
จับลูกบิดประตูแล้วหมุนมัน|t͡ɕabluːkabitpratuːlɛːwhamunman
จากนั้นทำอะไรต่อดี|t͡ɕaːknanatʰaำʔarajtɔːdiː
จากนั้นเรื่องราวของคุณนายดีนก็ได้สิ้นสุดลง|t͡ɕaːknanarɯːa̯ŋraːwakʰɔːŋkʰunanaːjdiːnaka็dajsinsudaloŋ
จากเอกสาร|t͡ɕaːkʔeːkasaːn
จิตสำนึกที่ดีหมายถึงการนอนหลับที่ดีขึ้น|t͡ɕitsaำnɯktʰiːdiːhmaːjatʰɯŋkaːranɔːnhalabtʰiːdiːkʰɯn
จีฟส์ทำมันเมื่อฉันได้รับการยืนยันอำนาจของฉัน|t͡ɕiːftʰaำmanmɯːa̯t͡ɕʰandajrabkaːrajɯːnjanɔːำnaːtkʰɔːŋat͡ɕʰan
จึงตัดสินใจขายการหาประโยชน์ในตลาดมืด|t͡ɕɯŋtadasint͡ɕajkʰaːjkaːrahaːprajoːtnajtalaːtmɯːt
จูนปฏิเสธการเกษียณ|t͡ɕuːnpatiseːtkaːrakeːsiːjon
จูเลีย|t͡ɕuːliːa̯
ฉันกล้าพูดว่าคุณควรทำ|t͡ɕʰanklaːpʰuːtwaːkʰunkʰwontʰaำ
ฉันก็เกิดแรงบันดาลใจขึ้นมากะทันหัน|t͡ɕʰanka็kɤtrɛːŋabandaːlat͡ɕajkʰɯnmaːkatʰanhan
ฉันขออย่างหลังดีกว่า|t͡ɕʰankʰaʔɔːjaːŋhalaŋdiːkwaː
ฉันขอแนะนำให้ทำก่อนที่คุณจะแก่เกินไป|t͡ɕʰankʰɔːnɛnaำhajtʰaำkɔːntʰiːkʰunt͡ɕakɛːkɤnpaj
ฉันควรจะคิดเขาพูดอย่างเคร่งขรึม|t͡ɕʰankʰwont͡ɕakʰitkʰeːaːpʰuːdɔːjaːŋkʰeːroŋkʰrɯm
ฉันคิดว่าฉันจะสวยขึ้นเร็ว|t͡ɕʰankʰidawaːt͡ɕʰant͡ɕasowjakʰɯnreːw
ฉันจะทำให้ดีที่สุดเพื่อไม่ให้เปื้อนพรม|t͡ɕʰant͡ɕatʰaำhajdiːtʰiːsutpʰɯːa̯majhajpɯːa̯npʰrom
ฉันจะพูด|t͡ɕʰant͡ɕapʰuːt
ฉันจะลองดูถ้าคุณชอบ|t͡ɕʰant͡ɕalɔːŋduːtʰaːkʰunt͡ɕʰɔːb
ฉันจะไม่ทำบุญมากหรือน้อย|t͡ɕʰant͡ɕamajtʰaำbujmaːkohrɯːɔːnɔːj
ฉันจะไม่ทำร้ายเธอเพื่อโลกนี้|t͡ɕʰant͡ɕamajtʰaำraːjtʰɤːpʰɯːa̯loːkniː
ฉันจำเป็นจะต้องจำมากกว่าไปไล่ตามทีหลัง|t͡ɕʰant͡ɕaำpeːnt͡ɕatɔːŋt͡ɕaำmaːkkwaːpajlajtaːmtʰiːhalaŋ
ฉันจำเป็นต้องส่งจดหมายนี้|t͡ɕʰant͡ɕaำpeːntɔːŋotŋat͡ɕothamaːjniː
ฉันจำเป็นต้องเพิกถอนค่าใช้จ่าย|t͡ɕʰant͡ɕaำpeːntɔːŋapʰɤktʰɔːnakʰaːt͡ɕʰajt͡ɕaːj
ฉันจ่ายทั้งวันในสวน|t͡ɕʰant͡ɕaːjatʰaŋwananajsawon
ฉันฉุน|t͡ɕʰant͡ɕʰun
ฉันชอบดอกไม้ที่อยู่ในแจกัน|t͡ɕʰant͡ɕʰɔːbadɔːkmajtʰiːɔːjuːnajt͡ɕɛːkan
ฉันชอบทานไซรัปกับแพนเค้ก|t͡ɕʰant͡ɕʰɔːbatʰaːnsajrapkabapʰɛːnkʰeːk
ฉันชอบพิงมัน|t͡ɕʰant͡ɕʰɔːbapʰiŋman
ฉันดีใจที่ได้ยินสิ่งนี้|t͡ɕʰandiːt͡ɕajtʰiːdajinsiŋaniː
ฉันตีลังกาได้|t͡ɕʰantiːlaŋkaːdaj
ฉันต้องการทำมันให้เนี๊ยบตามหุ่นยนต์|t͡ɕʰantɔːŋakaːntʰaำmanhajniːa̯btaːmahunjon
ฉันต้องไปพัก|t͡ɕʰantɔːŋapajpʰak
ฉันถามเขาในขณะที่ฉันพึมพำมันอย่างเงียบ|t͡ɕʰantʰaːmakʰeːaːnajkʰanatʰiːt͡ɕʰanpʰɯmapʰaำmanɔːjaːŋŋiːa̯b
ฉันถามเขาในขณะที่ฉันพึมพำมันอย่างเงียบเงียบมาตลอด|t͡ɕʰantʰaːmakʰeːaːnajkʰanatʰiːt͡ɕʰanpʰɯmapʰaำmanɔːjaːŋŋiːa̯baŋiːa̯bmaːtalɔːt
ฉันทนไฟอะไรก็ตามได้ดีกว่าไฟของการยิงคำถามจากทนายฝ่ายตรงข้าม|t͡ɕʰantʰanafajʔarajka็taːmdajdiːkwaːfajkʰɔːŋkaːrajiŋkʰaำtʰaːmt͡ɕaːkotnaːjafaːjtroŋkʰaːm
ฉันบอกเธอฉันยังมีความหวัง|t͡ɕʰanbɔːkatʰɤːt͡ɕʰanjaŋamiːkwaːmohwaŋ
ฉันปราศจากความหมาย|t͡ɕʰanpraːtt͡ɕaːkokwaːmohmaːj
ฉันพบว่าการยึดถือนอร์สและเซลติกน่าหลงใหล|t͡ɕʰanpʰabawaːkaːnjɯdatʰɯːɔːnɔːtlɛseːntikanaːhlaŋahajlaʔ
ฉันพูดว่าไม่ว่าอะไรจะเกิดขึ้น|t͡ɕʰanpʰuːdawaːmajwaːʔarajt͡ɕakɤtkʰɯn
ฉันมักจะจามเสมอหลังจากกินองุ่น|t͡ɕʰanmakat͡ɕat͡ɕaːmseːmɔːhlaŋat͡ɕaːkkinɔːŋun
ฉันมาเพื่อพิสูจน์ตัวเองเท่านั้น|t͡ɕʰanmaːpʰɯːa̯pʰisuːttuːa̯ʔeːŋtʰeːaːnan
ฉันมีความสุขเกินไปที่จะได้รับการร้องขอดังกล่าว|t͡ɕʰanmiːkʰwaːmsukʰakɤnpajtʰiːt͡ɕadajrabkaːrarɔːŋkʰɔːdaŋklaːw
ฉันยังไม่เคยเห็นมหาสมุทรแปซิฟิก|t͡ɕʰanjaŋamajkʰeːjheːnomhaːsamutrapɛːsifik
ฉันยังไม่ได้ตัดสินใจ|t͡ɕʰanjaŋamajdajtatsinat͡ɕaj
ฉันล่ะสงสัยจริง|t͡ɕʰanlasoŋsajotriŋ
ฉันว่าฉันจะแบ่งอาหารให้คุณในตอนนี้แล้วล่ะ|t͡ɕʰanwaːt͡ɕʰant͡ɕabɛːŋʔaːhaːnhajkʰunnajtɔːnniːlɛːwlaʔ
ฉันว่าเราต้องล่อเขาออกไป|t͡ɕʰanwaːreːaːtɔːŋlɔːkʰeːaːʔɔːkpaj
ฉันสามารถซื้อด้วยตัวเอง|t͡ɕʰansaːmaːntʰasɯːɔːtwajatuːa̯ʔeːŋ
ฉันสามารถเจาะรูบนประตูเหล็กได้|t͡ɕʰansaːmaːntʰat͡ɕɔruːbnopratuːheːla็kadaj
ฉันสามารถเห็นบ้านของฉันจากที่นี่|t͡ɕʰansaːmaːntʰaheːnbaːnakʰɔːŋt͡ɕʰanat͡ɕaːktʰiːniː
ฉันหมายถึงที่ฉันพูด|t͡ɕʰanhamaːjtʰɯŋatʰiːt͡ɕʰanpʰuːt
ฉันหวังว่าจะได้เต้นรำครั้งต่อไป|t͡ɕʰanhawaŋwaːt͡ɕadajteːnraำkʰraŋtɔːpaj
ฉันอยากจะเป็นนักเขียนสิ่งตีพิมพ์ตอนที่โตเป็นผู้ใหญ่|t͡ɕʰanɔːjaːkt͡ɕapeːnnakakʰiːa̯nsiŋatiːpʰimtɔːnatʰiːtoːpeːnpʰuːhajjaʔ
ฉันอยากได้ผู้ช่วยเรื่องเสียงที่เป็นคนพื้นที่|t͡ɕʰanɔːjaːkdajpʰuːtwajarɯːa̯ŋsiːa̯ŋatʰiːpeːnkʰanapʰɯːntʰiː
ฉันออกจากทางรถไฟ|t͡ɕʰanʔɔːkat͡ɕaːktʰaːŋontʰafaj
ฉันเกรงว่าฉันจะเมานิดหน่อย|t͡ɕʰankeːroŋwaːt͡ɕʰant͡ɕameːaːnithanɔːj
ฉันเกรงใจเธอจริง|t͡ɕʰankeːroŋt͡ɕajtʰɤːtriŋ
ฉันเกิดในเดือนมกราคมซึ่งเป็นเดือนแรกในอายุสิบเจ็ดปี|t͡ɕʰankɤdanajdɯːa̯nmokraːkmasɯŋpeːnadɯːa̯nrɛːkanajʔaːjusibt͡ɕeːdapiː
ฉันเคยมีประสบการณ์กับเวอร์ติโก|t͡ɕʰankʰeːjamiːprasobkaːrakabwɤːtikoː
ฉันเชื่อว่าคุณมีความเต็มใจขับรถ|t͡ɕʰant͡ɕʰɯːa̯waːkʰunmiːkʰwaːmteːmat͡ɕajkʰabrot
ฉันเริ่มจากเขา|t͡ɕʰanrɤmat͡ɕaːkkʰeːaː
ฉันเรียกมันว่าการกรนของแมว|t͡ɕʰanriːa̯kamanwaːkaːnkronkʰɔːŋamɛːw
ฉันเรียนรู้มันผ่านช่องดิสคัฟเวอรี่|t͡ɕʰanriːa̯naruːmanpʰaːnat͡ɕʰɔːŋdisakʰafwɤːriː
ฉันเลี้ยงคิ้ว|t͡ɕʰanliːa̯ŋakʰiw
ฉันเห็นเขากัดฟันมากกว่ายิ้มนะ|t͡ɕʰanheːnakʰeːaːkatfanamaːkkwaːjimnaʔ
ฉันแสดงให้คุณดู|t͡ɕʰansɛːdoŋhajkʰunduː
ฉันได้พบพยาบาลที่ใจดี|t͡ɕʰandajpʰobpʰajaːbaːntʰiːt͡ɕajdiː
ฉันได้ยินเธอสะอึก|t͡ɕʰandajintʰɤːsaʔɯk
ฉันได้รับมรดกเป็นรูปปั้นในพินัยกรรมของยายของฉัน|t͡ɕʰandajrabmarotkapeːnruːpapannajpʰinajkronmakʰɔːŋjaːjakʰɔːŋt͡ɕʰan
ฉันได้วิเคราะห์ดูรายงานแล้วและก็ไม่พบข้อผิดพลาดใด|t͡ɕʰandajwikʰeːraːaduːraːjŋaːnalɛːwlɛka็majpʰobkʰɔːpʰitpʰlaːtdaj
ฉันไม่จำเป็นต้องรับผิดชอบอะไรในชีวิต|t͡ɕʰanmajt͡ɕaำpeːntɔːŋarabpʰidat͡ɕʰɔːbʔarajnajt͡ɕʰiːwit
ฉันไม่ชอบเกมนี้เลย|t͡ɕʰanmajt͡ɕʰɔːbkeːmaniːleːj
ฉันไม่ทำมันก็เหมือนกับการหัวรั้น|t͡ɕʰanmajtʰaำmanka็heːmɯːɔːnkabakaːnhuːa̯ran
ฉันไม่พูดอะไร|t͡ɕʰanmajpʰuːtʔaraj
ฉันไม่มีเงินเหลือเลยสักบาท|t͡ɕʰanmajmiːŋɤnheːlɯːɔːleːjsakabaːt
ฉันไม่สนใจทัศนคติของเธอหรอกนะ|t͡ɕʰanmajsont͡ɕajtʰatnakʰatikʰɔːŋtʰɤːharɔːknaʔ
ฉันไม่เคยเข้าบาร์เพราะชอบกิจกรรมอย่างอื่นมากกว่า|t͡ɕʰanmajkʰeːjkʰeːaːbaːpʰeːraːat͡ɕʰɔːbkit͡ɕokraramɔːjaːŋʔɯːnamaːkkwaː
ฉันไม่เคยเห็นว่าเขาน่าเข้าหามาก่อน|t͡ɕʰanmajkʰeːjheːnawaːkʰeːaːnaːkʰeːaːhaːmaːkɔːn
ฉันไม่เคยเห็นเขาเลย|t͡ɕʰanmajkʰeːjheːnakʰeːaːleːj
ฉันไม่ได้ทำอะไรดี|t͡ɕʰanmajdajtʰaำʔarajdiː
ฉันไม่ได้อาบน้ำวันนี้|t͡ɕʰanmajdajʔaːbnaำwanniː
ฉันไม่ได้แผ่เตียงนอนออกอย่างดูดี|t͡ɕʰanmajdajpʰɛːtiːa̯ŋnɔːnaʔɔːkɔːjaːŋduːdiː
ชั้นก็ไม่ได้สนใจนักหรอกว่าที่ไหนที่|t͡ɕʰanka็majdajsont͡ɕajnakharɔːkwaːtʰiːhajnatʰiː
ชาติหน้า|t͡ɕʰaːtihnaː
ชาลอตวางกุญแจของเธอไว้ที่ไหน|t͡ɕʰaːlɔːtwaːŋakujt͡ɕɛːkʰɔːŋtʰɤːwajtʰiːhajnaʔ
ชีสอร่อยมาก|t͡ɕʰiːsɔːrɔːjmaːk
ช่วยมีระบบยืนยันอีเมลก่อนได้ไหม|t͡ɕʰowjamiːrabbajɯːnjanaʔiːmeːnkɔːnadajhajmaʔ
ช่วยโจรจากตะแลงแกงแล้วเขาจะตัดคอของคุณ|t͡ɕʰowjat͡ɕoːnt͡ɕaːkatalɛːŋkɛːŋalɛːwkʰeːaːt͡ɕatatkʰɔːkʰɔːŋkʰun
ช่างทำหมวกพูด|t͡ɕʰaːŋtʰaำhomwakapʰuːt
ซึ่งทั้งหมดต้องงัดเปลือกออก|sɯŋtʰaŋohmadatɔːŋŋadapeːlɯːɔːkʔɔːk
ซึ่งทำให้ไฟตกทั้งระบบ|sɯŋtʰaำhajfajtoktʰaŋarabob
ซึ่งสะท้อนมาถึงภาคการศึกษา|sɯŋsatʰɔːnmaːtʰɯŋpʰaːkʰakaːnsɯkasaː
ซึ่งอยู่ผิดทาง|sɯŋɔːjuːpʰittʰaːŋ
ดวงอาทิตย์ขึ้นทำให้ท้องฟ้าทิศตะวันออกสว่าง|dowŋaʔaːtʰitkʰɯnatʰaำhajtʰɔːŋfaːtʰittawanʔɔːkotwaːŋ
ดังนั้นเขาควรจะ|daŋnanakʰeːaːkwarat͡ɕaʔ
ดัมตี้กล่าว|damtiːklaːw
ดีกว่าเขาพูดอย่างร่าเริง|diːkwaːkʰeːaːpʰuːdɔːjaːŋraːrɤŋ
ดีเชียวล่ะ|diːt͡ɕʰiːa̯wlaʔ
ดู|duː
ดูที่นี่โทนี่พูด|duːtʰiːniːtʰoːniːpʰuːt
ดูน้ำใสและปลาปู|duːnaำsajlɛplaːpuː
ดูรอบตัวเธอที่รักและพิจารณามัน|duːrɔːbtuːa̯tʰɤːtʰiːraklɛpʰit͡ɕaːnnaːman
ดูสิว่านักกีฬาเหล่านี้มีความยืดหยุ่นแค่ไหน|duːsiwaːnakkiːlaːheːlaːniːmiːkwaːmajɯːthajunkʰɛːhajnaʔ
ดูเหมือนจะมืดมนสำหรับแฮรี่|duːheːmɯːɔːnt͡ɕamɯːtmanasaำharabhɛːriː
ดูเหมือนว่าฉันจะหมดอาหารเช้าแล้ว|duːheːmɯːɔːnwaːt͡ɕʰant͡ɕahomdaʔaːhaːnt͡ɕʰeːaːlɛːw
ดูเหมือนเขาจะถูกใจเด็กหนุ่มคนนีขึ้นมาทันทีนะ|duːheːmɯːɔːnkʰeːaːt͡ɕatʰuːkt͡ɕajdeːkhanumkʰananiːkʰɯnmaːtʰantʰiːnaʔ
ด้วยกำปั้นที่กำแน่น|dowjakaำpantʰiːkaำnɛːn
ด้วยความยินดีค่ะ|dowjokʰwaːmjinadiːkʰaʔ
ด้วยภาพ|dowjapʰaːp
ตรงนี้ไง|tonŋaniːŋaj
ตรวจสอบให้แน่ใจว่าการออกแบบสไลด์ของคุณมีการเลือกสีและความคมชัดที่เหมาะสม|tonwat͡ɕasɔːbhajnɛːt͡ɕajwaːkaːnʔɔːkabɛːbsalajkʰɔːŋkʰunamiːkaːnlɯːa̯kasiːlɛkwaːmokmat͡ɕʰattʰiːheːmaːasom
ตอนนี้ทุกอย่างตรวจสอบความปลอดภัยด้วยพาสเวิร์ด|tɔːnniːtʰukɔːjaːŋtrowt͡ɕasɔːbkʰwaːmplɔːtpʰajotwajapʰaːtwɤt
ตอนนี้เขากำลังอ่านหนังสือ|tɔːnniːkʰeːaːkaำlaŋʔaːnohnaŋasɯːɔː
ตอนนี้เขาจึงต้องหาที่หลบภัยในต่างประเทศ|tɔːnniːkʰeːaːt͡ɕɯŋtɔːŋahaːtʰiːhlabapʰajnajtaːŋpratʰeːt
ตอนนี้เป็นไปได้ที่จะทำเครื่องหมายสถานที่สำคัญทางประวัติศาสตร์เข้าสู่โลกเสมือนจริง|tɔːnniːpeːnpajdajtʰiːt͡ɕatʰaำkʰeːrɯːɔːŋhamaːjsatʰaːntʰiːsaำkʰajtʰaːŋoprawatisaːttakʰeːaːsuːloːkseːmɯːɔːnt͡ɕariŋ
ตัวแทนสมาคมอีคอมเมิร์ช|tuːa̯tʰɛːnsamaːkmaʔiːkʰɔːmmɤt
ตั้งกรรมการใหม่|taŋkronmakaːnhajmaʔ
ตั้งตามชื่อสกุลของพระยาพหลพลพยุหเสนา|taŋtaːmat͡ɕʰɯːɔːtkulakʰɔːŋpʰrajaːphaloplapʰajuhseːnaː
ตั้งแต่เริ่มต้นมา|taŋtɛːrɤmtanamaː
ตากใบ|taːkbaj
ตำนานเกี่ยวกับพระเจ้าสายน้ำผึ้งและพระนางสร้อยดอกหมากเล่าว่า|taำnaːnkiːa̯wakabpʰrat͡ɕeːaːsaːjnaำpʰɯŋlɛpʰranaːŋsarɔːjdɔːkohmaːkleːaːwaː
ตีห้า|tiːhaː
ตู้เสื้อผ้านั่นใหญ่แค่ไหน|tuːsɯːa̯pʰaːnanhajjakʰɛːhajnaʔ
ต่อคนกินเช่น|tɔːknakint͡ɕʰeːn
ต่อไปอาจเปลี่ยนชื่อถนนด้วยไหม|tɔːpajʔaːtpeːliːjnat͡ɕʰɯːɔːtnanotwajahajmaʔ
ต่างกับกัญชาอย่างไร|taːŋkabakajt͡ɕʰaːɔːjaːŋraj
ต้องพิสูจน์ให้ได้|tɔːŋpʰisuːthajdaj
ต้องลุ้นให้วิญญาณกลับไปอยู่สวรรค์เมืองจีนอ่ะ|tɔːŋlunahajwijjaːnoklabapajɔːjuːtwaronmɯːa̯ŋat͡ɕiːnʔaʔ
ต้องใช้ความร้อนดึงกลิ่นออกมา|tɔːŋt͡ɕʰajkʰwaːmrɔːnadɯŋklinʔɔːkamaː
ถนนสูงชันจนผู้ขับขี่ต้องเปลี่ยนเกียร์ไม่กี่คัน|tʰonnasuːŋt͡ɕʰanotnapʰuːkʰabkʰiːtɔːŋpeːliːjnakiːa̯majkiːkʰan
ถามอะไรกัน|tʰaːmʔarajkan
ถุงพลาสติกเป็นปัญหาต่อสิ่งแวดล้อม|tʰuŋpʰlaːttikapeːnpajahaːtɔːsiŋwɛːdalɔːm
ถ้าคุณรู้ว่าฉันหมายความว่าอะไร|tʰaːkʰunruːwaːt͡ɕʰanhamaːjkʰwaːmwaːʔaraj
ถ้าคุณอยากเอามา|tʰaːkʰunɔːjaːkʔeːaːmaː
ถ้าจะอวดอ้างสรรพคุณ|tʰaːt͡ɕaɔːwdaʔaːŋsaronpʰakʰun
ถ้าฉันหมายความว่าอย่างนั้น|tʰaːt͡ɕʰanhamaːjkʰwaːmwaːɔːjaːŋnan
ถ้าพวกเขาเข้ามาใกล้กว่านี้|tʰaːpwakakʰeːaːkʰeːaːmaːkajlokwaːniː
ถ้าพวกเรายังอยู่ที่นี้พวกเราต้องการแบบนั้นแหละ|tʰaːpwokreːaːjaŋɔːjuːtʰiːniːpwokreːaːtɔːŋkaːrabɛːbnanahɛːlaʔ
ถ้าพวกเรารู้ว่าผู้บริโภคต้องการอะไรแล้วละก็|tʰaːpwokreːaːruːwaːpʰuːbripʰoːktɔːŋakaːnʔarajlɛːwlaka็
ถ้าอย่างนั้น|tʰaːɔːjaːŋnan
ถ้าอีกหน่อยหม้อหุงข้าวต่อเน็ตได้ก็คงโดนดักข้อมูลว่า|tʰaːʔiːkhanɔːjhamɔːhuŋkʰaːwatɔːneːtdajka็kʰoŋdoːnadakkʰɔːmuːnwaː
ถ้าเชื่อว่าผู้ควบคุมปัจจัยการผลิตเศรษฐกิจคือผู้ควบคุมอำนาจการเมือง|tʰaːt͡ɕʰɯːa̯waːpʰuːkwabakʰumpat͡ɕat͡ɕajkaːroplitaseːnsatʰakitkʰɯːɔːpʰuːkwabakʰumɔːำnaːtkaːramɯːa̯ŋ
ถ้าเธอพูด|tʰaːtʰɤːpʰuːt
ถ้าเธออยากได้|tʰaːtʰeːʔɔːjaːkdaj
ถ้าเปลี่ยนชื่อ|tʰaːpeːliːjnat͡ɕʰɯːɔː
ถ้าเอากระดูกของหมาไปแล้วจะเหลืออะไร|tʰaːʔeːaːkraduːkkʰɔːŋohmaːpajlɛːwt͡ɕaheːlɯːʔɔːaraj
ถ้าให้เลือกระหว่างน้ำผึ้งกับแยม|tʰaːhajlɯːa̯krahawaːŋnaำpʰɯŋkabajɛːm
ถ้าได้|tʰaːdaj
ถ้าไม่พอใจ|tʰaːmajpʰɔːt͡ɕaj
ทรอปิกออฟแคปริคอร์นอยู่ในซีกโลกใต้|tʰrɔːpikʔɔːfakʰɛːprikʰɔːnɔːjuːnajsiːkloːkataj
ทันตแพทยศาสตรบัณฑิต|tʰantapʰɛːtjasaːttrabantʰit
ทันเดอร์และฟ้าผ่าเร่งรีบด้วยการพักผ่อน|tʰandɤːlɛfaːpʰaːreːŋriːbotwajakaːnpʰakapʰɔːn
ทันใดนั้นประภาคารก็มืด|tʰandajnanprapʰaːkʰaːnka็mɯːt
ทำช้าลง|tʰaำt͡ɕʰaːloŋ
ทำให้ฉันเริ่มอยากทำอย่างนั้น|tʰaำhajt͡ɕʰanrɤmɔːjaːktʰaำɔːjaːŋnan
ทำไมคุณคิดแบบนั้น|tʰaำmajkʰunkʰidabɛːbnan
ทำไมฉันถึงรู้สึกวิงเวียนศีรษะ|tʰaำmajt͡ɕʰantʰɯŋaruːsɯkwiŋawiːa̯nsiːrasaʔ
ทำไมถึงทิ้งการครอบครองของคุณไว้|tʰaำmajtʰɯŋtʰiŋakaːnkʰrɔːbkʰrɔːŋkʰɔːŋakʰunwaj
ทำไมถึงไม่พูดกับพวกเรา|tʰaำmajtʰɯŋmajpʰuːtkabopwokreːaː
ทำไมผมต้องตามหาเธอบ่อยนักทั้งที่ผมก็ไม่ค่อยจะใส่ใจเธอ|tʰaำmajpʰomtɔːŋataːmhaːtʰɤːbɔːjnakatʰaŋtʰiːpʰomka็majkʰɔːjt͡ɕasajt͡ɕajtʰɤː
ที่นี้มีลูกแมวสองสามตัวกำลังจ้องมองมา|tʰiːniːmiːluːkmɛːwasɔːŋsaːmatuːa̯kaำlaŋt͡ɕɔːŋamɔːŋmaː
ที่ประเพณีบ้านเขาจะรู้อะไรบางอย่าง|tʰiːprapʰeːniːbaːnkʰeːaːt͡ɕaruːʔarajbaːŋɔːjaːŋ
ที่ว่าการเรียนคณิตศาสตร์นี้|tʰiːwaːkaːnriːa̯noknitasaːttaniː
ที่เราใช้อยู่นี้ไม่ได้ตอบโจทย์นี้|tʰiːreːaːt͡ɕʰajɔːjuːniːmajdajtɔːbt͡ɕoːtʰaniː
ที่โรงพยาบาลแห่งหนึ่ง|tʰiːroːŋpʰajaːbaːnhɛːŋohnɯŋ
ที่ใช้เป็นสถานที่กักตัว|tʰiːt͡ɕʰajpeːnsatʰaːntʰiːkaktuːa̯
ที่ไม่มีอาการแปลกใจ|tʰiːmajmiːʔaːkaːnpɛːlokt͡ɕaj
ท่าทางเนี้ยบของเขาหายไปแล้ว|tʰaːtʰaːŋniːa̯bakʰɔːŋkʰeːaːhaːjpajlɛːw
ท่านครับ|tʰaːnkʰrab
นกทั้งหมดเริ่มส่งเสียงร้องตอนที่แสงแรกของวันสาดส่องมา|noktʰaŋohmadarɤmsaŋasiːa̯ŋrɔːŋatɔːntʰiːsɛːŋrɛːkakʰɔːŋwanasaːtsɔːŋamaː
นอกจากจะปฏิเสธการขายอาหารให้เราแล้ว|nɔːkt͡ɕaːkat͡ɕaptiseːtkaːrakʰaːjʔaːhaːnhajreːaːlɛːw
นอกจากนี้|nɔːkt͡ɕaːkaniː
นอกจากนี้ยังมีความสับสนว่ามีการเปลี่ยนแปลงภายใน|nɔːkt͡ɕaːkaniːjaŋmiːkʰwaːmsabotnawaːmiːkaːnpeːliːjnapɛːnŋapʰaːjnaj
นักวิเคราะห์รายงานผลและพบว่ามีข้อผิดพลาดเกิดขึ้นในมุมมองของงานที่นำเสนอ|nakwikʰeːraːaraːjŋaːnoplalɛpbawaːmiːkʰɔːpʰitpʰlaːtkɤdakʰɯnnajmummɔːŋakʰɔːŋŋaːnatʰiːnaำseːnɔː
นั่นคงจะตลกถ้าเขาทำ|nankʰaŋat͡ɕatlakatʰaːkʰeːaːtʰaำ
นั่นคือทาง|nankʰɯːɔːtʰaːŋ
นั่นคือสิ่งที่มันเป็น|nankʰɯːɔːsiŋtʰiːmanpeːn
นั่นเป็นครั้งสุดท้ายที่เราได้เห็นฟรังโคกับเปอโร|nanpeːnokraŋasuttʰaːjatʰiːreːaːdajheːnfaraŋkʰoːkabpɤːroː
นางสาวซัมเมอร์สันเขาพูดซ้ำแล้วมองมาที่ฉันอีก|naːŋsaːwasammɤːsankʰeːaːpʰuːtsaำlɛːwmɔːŋamaːtʰiːt͡ɕʰanʔiːk
นางสาวไทยหรอกเหรอ|naːŋsaːwatʰajharɔːkheːrɔː
นายกออกทีวีเมื่อเย็นนี้|naːjkaʔɔːktʰiːwiːmɯːa̯jeːnniː
นิทรรศการศิลปะ|nitrarotkaːrasinpaʔ
นิทานปากเปล่า|nitʰaːnpaːkapeːlaː
นิยายเรื่องแรกของฉันเกี่ยวกับเด็กสองคนที่ขโมยมงกุฏ|nijaːjrɯːa̯ŋarɛːkkʰɔːŋat͡ɕʰankiːa̯wakabdeːkasɔːŋkʰanatʰiːkmoːjomŋakut
นิ้วของเธอชี้เป้าหมายไปที่มารดา|niwkʰɔːŋatʰɤːt͡ɕʰiːpeːaːhmaːjapajtʰiːmaːndaː
นี่คือประโยคภาษาไทยที่พูดโดย|niːkʰɯːɔːprajoːkpʰaːsaːtʰajtʰiːpʰuːtdoːj
นี่คือภาษาที่แข็งแกร่ง|niːkʰɯːɔːpʰaːsaːtʰiːkʰɛː็ŋakɛːroŋ
นี่คือเหตุผลที่มีพวกเครื่องถ้วยกาชงชามากมายข้างนอกนั่นเหรอ|niːkʰɯːɔːheːtuplatʰiːmiːpwakakʰeːrɯːɔːŋtʰawojkaːt͡ɕʰoŋt͡ɕʰaːmaːkmaːjakʰaːŋnɔːkananheːrɔː
นี่มันสำหรับพวกเขา|niːmansaำharabpʰawokkʰeːaː
นี่แหละทั้งหมด|niːhɛːlatʰaŋhamot
นี่ไง|niːŋaj
นี้หลังจากที่ฉันไปเบลเยี่ยม|niːhlaŋat͡ɕaːktʰiːt͡ɕʰanpajbeːnjiːa̯m
น่าจะเป็นอย่างนั้น|naːt͡ɕapeːnɔːjaːŋnan
น่าเสียดายที่ไทยไม่ได้ผลิตเทคโนโลยีห้าจีของตัวเอง|naːsiːa̯daːjtʰiːtʰajmajdajpʰlittʰeːkʰanoːloːjiːhaːt͡ɕiːkʰɔːŋtuːa̯ʔeːŋ
บนยอดของปล่องไฟ|bonjɔːdakʰɔːŋplɔːŋfaj
บรรจุภัณฑ์เสียหาย|bonrat͡ɕupʰansiːa̯haːj
บริการส่งสินค้า|barikaːnsaŋasinkʰaː
บริษัทใหญ่ทางด้านเทคโนโลยีของโลกกำลังลงทุนไปเยอะ|barisathajjatʰaːŋdaːnatʰeːknoːloːjiːkʰɔːŋloːkakaำlaŋlaŋatʰunpajeːʔaʔ
บางคนก็กล่าวหาว่าเขาดูหมิ่นศาสนา|baːŋkʰanaka็klaːwhaːwaːkʰeːaːduːhminasaːtnaː
บางทีวันพรุ่งนี้อาจจะดีกว่าเมื่อวานก็ได้นะ|baːŋtʰiːwanpʰruŋniːʔaːtt͡ɕadiːkwaːmɯːa̯waːnka็dajnaʔ
บางประโยคแปลมาไม่ใช่สำนวนไทย|baːŋprajoːkpɛːlamaːmajt͡ɕʰajsaำnownatʰaj
บ้านสีดำมีเสียงระเบิด|baːnsiːdaำmiːsiːa̯ŋrabɤt
บ้านเหล่านั้นดูอัดแน่นเหมือนปลาซาร์ดีน|baːnheːlaːnanduːʔatnɛːnaheːmɯːɔːnplaːsaːdiːn
ประชาชนเป็นผู้จ่ายภาษีให้รัฐบาล|prat͡ɕʰaːtnapeːnpʰuːt͡ɕaːjpʰaːsiːhajratbaːn
ประตูถูกพบว่าไม่ได้ล็อคใช่ไหม|pratuːtʰuːkpʰabawaːmajdajla็ɔːkt͡ɕʰajhajmaʔ
ประมาณนี้ค่ะ|pramaːnniːkʰaʔ
ประวัติการคุมกำเนิด|prawatikaːnkʰumakaำnɤt
ประเทศไทย|pratʰeːttʰaj
ประเทศไอร์แลนด์|pratʰeːtʔajlɛːn
ปรับตัวไม่ทัน|prabtuːa̯majtʰan
ปลากุเลาเค็ม|plaːkuleːaːkʰeːm
ปลาทูน่าราคาแพง|plaːtʰuːnaːraːkʰaːpʰɛːŋ
ปักเป็นขาพัดกันกุมารวาง|pakpeːnakʰaːpʰatkanakumaːnwaːŋ
ปัญหาสุขภาพ|pajhaːsukpʰaːp
ปู่กับย่าคอยเป็นกำลังใจให้เสมอ|puːkabjaːkʰɔːjpeːnakaำlaŋt͡ɕajhajseːmɔː
ป้าของฉันไม่ต้องการให้เขาทำแบบนั้น|paːkʰɔːŋt͡ɕʰanamajtɔːŋkaːrahajkʰeːaːtʰaำbɛːbnan
ผมก็ไม่รู้เหมือนกัน|pʰomka็majruːheːmɯːɔːnkan
ผมขอให้คุณมีความสุขมาก|pʰomkʰɔːhajkʰunmiːkʰwaːmsukʰamaːk
ผมตรวจสอบเอกสารทั้งหมดของเขาและผลกระทบของเขาทั้งหมด|pʰomtrowt͡ɕasɔːbʔeːkasaːntʰaŋohmadakʰɔːŋkʰeːaːlɛplokratbakʰɔːŋkʰeːaːtʰaŋhamot
ผมวางมือไว้ที่ไหล่เขาอย่างนุ่มนวล|pʰomwaːŋamɯːɔːwajtʰiːhajlakʰeːaːɔːjaːŋnumonwon
ผมเปิดเบียร์เป็นกระป๋องที่แปด|pʰompɤdabiːa̯peːnkrapɔːŋtʰiːpɛːt
ผมไม่มีความคิดเกี่ยวกับงานนี้เลย|pʰommajmiːkwaːmakʰitkiːa̯wakabŋaːnaniːleːj
ผมไม่ได้อยู่ในห้องพิจารณาคดี|pʰommajdajɔːjuːnajhɔːŋpʰit͡ɕaːnnaːkʰadiː
ผู้ทรงคุณูปการต่อศิลปะไทยสมัยใหม่|pʰuːtraŋakʰunuːpkaːratɔːsinpatʰajsamajhajmaʔ
ผู้พิทักษ์ของฉันไม่ได้พยายามห้ามปรามฉันและฉันก็ไป|pʰuːpʰitʰakkʰɔːŋat͡ɕʰanmajdajpʰajaːjaːmhaːmopraːmat͡ɕʰanlɛt͡ɕʰanka็paj
ผู้ว่าราชการจังหวัดได้รับหีบห่อที่น่าสงสัยและตำรวจต้องการสอบสวน|pʰuːwaːraːtkaːrat͡ɕaŋhawatdajrabhiːbahɔːtʰiːnaːtŋasajlɛtaำrowt͡ɕatɔːŋkaːrasɔːbsawon
ผู้หญิงที่นั่งข้าง|pʰuːhjiŋatʰiːnaŋkʰaːŋ
ฝากส่งต่อให้เพื่อนด้วย|faːksaŋatɔːhajpʰɯːa̯ndawoj
พรุ่งนี้|pʰruŋniː
พร้อมที่จะค้นหาว่าเป็นความผิดของใคร|pʰrɔːmtʰiːt͡ɕaknahaːwaːpeːnkʰwaːmpʰidakʰɔːŋkʰajraʔ
พวกคุณเป็นผู้ชายของใคร|pʰowkakʰunpeːnapʰuːt͡ɕʰaːjkʰɔːŋakʰajraʔ
พวกเขายังปล่อยให้เราหาอาหารเองด้วย|pʰowkakʰeːaːjaŋplɔːjhajreːaːhaːʔaːhaːnʔeːŋotwoj
พวกเขาอยู่ไหนตอนนี้|pʰowkakʰeːaːɔːjuːhajnatɔːnniː
พวกเขาอาศัยอยู่ที่บ้าน|pʰowkakʰeːaːʔaːsajɔːjuːtʰiːbaːn
พวกเธอเป็นเหมือนสตรีแห่งค่ำคืน|pʰowkatʰɤːpeːnheːmɯːɔːnsotriːhɛːŋkʰaำkʰɯːn
พวกเรากำลังวางแผนที่จะไปเยี่ยมแกรนด์แคนยอน|pʰowkreːaːkaำlaŋwaːŋapʰɛːntʰiːt͡ɕapajiːa̯mkɛːronkʰɛːnajɔːn
พวกเราจะต้องค้นคว้าเอง|pʰowkreːaːt͡ɕatɔːŋkʰanokwaːʔeːŋ
พวกเราจะมาเจอกันตามเดิมใช่ไหม|pʰowkreːaːt͡ɕamaːt͡ɕɤːkantaːmadɤmt͡ɕʰajhajmaʔ
พวกเราจะไปดูฟุตบอลคืนนี้|pʰowkreːaːt͡ɕapajduːfutbɔːlakʰɯːnniː
พวกเรารู้ว่าตอนนี้เขาทำมันไปแล้ว|pʰowkreːaːruːwaːtɔːnniːkʰeːaːtʰaำmanpajlɛːw
พวกเราสิบแปดคนไม่สามารถเข้าไปในรถตู้ได้|pʰowkreːaːsibpɛːdoknamajsaːmaːntʰakʰeːaːpajnajrottuːdaj
พวกเราโชคดีไหม|pʰowkreːaːt͡ɕʰoːkdiːhajmaʔ
พวกเราไม่มีงบที่จะสร้างสตูดิโอที่มีคุณภาพ|pʰowkreːaːmajmiːŋbatʰiːt͡ɕatraːŋottuːdiʔoːtʰiːmiːkʰunpʰaːp
พวกเราไม่มีโอกาสมากพอจะไป|pʰowkreːaːmajmiːʔoːkaːtmaːkapʰɔːt͡ɕapaj
พหุสังคม|pʰahusaŋkʰom
พายุเฮอริเคนฉีกอาคารออกจากกัน|pʰaːjuhɤːrikʰeːnt͡ɕʰiːkaʔaːkʰaːnʔɔːkat͡ɕaːkkan
พาราเซตามอลช่วยบรรเทาอาการปวด|pʰaːraːseːtaːmɔːnt͡ɕʰawojbarontʰeːaːʔaːkaːnpawot
พีระศรี|pʰiːratriː
พ่อเป็นคนทอดปลานิล|pʰɔːpeːnkʰanatʰɔːtplaːnin
พ่อแม่เด็กพูดว่าเถียงพ่อเถียงแม่บาปหนักตกนรก|pʰɔːmɛːdeːkpʰuːdawaːtʰiːa̯ŋpʰɔːtʰiːa̯ŋmɛːbaːphanaktakonrok
ฟรี|fariː
ฟังโฆษณาทหาร|faŋkʰoːsanaːthaːn
ฟิล|fin
ฟิลิปจุดซิการ์แล้วหยิบเก้าอี้มานั่งตรงข้ามเขา|filipt͡ɕudasikaːlɛːwhajibkeːaːʔiːmaːnaŋtroŋkʰaːmakʰeːaː
ภรรยาของฉันคือแม่บ้าน|pʰonrajaːkʰɔːŋt͡ɕʰanakʰɯːɔːmɛːbaːn
ภาพแรกที่คิดในหัวพอพูดถึงคนนี้|pʰaːprɛːkatʰiːkʰitnajhuːa̯pʰɔːpʰuːttʰɯŋoknaniː
ภูมิแพ้อากาศ|pʰuːmipʰɛːʔaːkaːt
ภูเขาเอเวอร์เรสถูกค้นพบบนดินแดนกั้นเขตของจีนและเนปาล|pʰuːkʰeːaːʔeːwɤːreːttʰuːkoknapʰobbanadindɛːnakankʰeːtakʰɔːŋt͡ɕiːnalɛneːpaːn
มนุษยชาติกำลังใช้เงินจำนวนมากเป็นพันล้าน|manutjat͡ɕʰaːtikaำlaŋt͡ɕʰajŋɤnt͡ɕaำnownamaːkpeːnapʰanlaːn
มนุษย์ต่างดาวซบเซาและตบหนวดของมัน|manuttaːŋadaːwsabaseːaːlɛtbahonwadakʰɔːŋman
มนุษย์มีสัญชาตญาณในการเข้าใจเบื้องต้นเกี่ยวกับการสรุปสาเหตุ|manutmiːsajt͡ɕʰaːtajaːnnajkaːnkʰeːaːt͡ɕajbɯːa̯ŋtanakiːa̯wkabakaːnsarupsaːheːtuʔ
มรดกสมบูรณาญาสิทธิราชย์ในปัจจุบัน|mondakotmabuːnnaːjaːsittʰiraːtnajpatt͡ɕuban
มันก็เป็นอย่างที่ฉันพูดนั่นแหละ|manka็peːnɔːjaːŋtʰiːt͡ɕʰanpʰuːdananhɛːlaʔ
มันข้ามไปข้ามมากับพื้นที่อื่น|mankʰaːmapajkʰaːmmaːkabpʰɯːnatʰiːʔɯːn
มันคือระบบโซเฟีย|mankʰɯːɔːrabbasoːfiːa̯
มันง่ายกว่าที่จะรักษาเนื้องอกก่อนที่มันจะแพร่กระจาย|manŋaːjokwaːtʰiːt͡ɕaraksaːnɯːa̯ŋɔːkkɔːnatʰiːmant͡ɕapʰɛːnkrat͡ɕaːj
มันจบแล้ว|mant͡ɕabalɛːw
มันจะดีกว่ามาก|mant͡ɕadiːkwaːmaːk
มันจะเติมเต็มความต้องการในสัญญาได้อย่างแน่นอน|mant͡ɕatɤmteːmokwaːmatɔːŋkaːranajsajjaːdajɔːjaːŋnɛːnɔːn
มันจะเป็นสิ่งที่ยอดเยี่ยมมากสำหรับพวกเรา|mant͡ɕapeːnsiŋatʰiːjɔːtjiːa̯mamaːksaำharabpʰawokreːaː
มันช่างเป็นคำแนะนำที่แสนวิเศษจริง|mant͡ɕʰaːŋapeːnkʰaำnɛnaำtʰiːsɛːnwiseːtt͡ɕariŋ
มันช่างไพเราะเสนาะหู|mant͡ɕʰaːŋapʰajrɔseːnaːahuː
มันช่างไม่น่าให้อภัยและอธิบายไม่ได้|mant͡ɕʰaːŋamajnaːhajɔːpʰajlɛɔːtʰibaːjmajdaj
มันดีกว่าการมีเจ้าหน้าที่ศาลมาเคาะถึงหน้าประตูในเรื่องนั้น|mandiːkwaːkaːnmiːt͡ɕeːaːhnaːtʰiːsaːnmaːkʰɔtʰɯŋhanaːpratuːnajrɯːa̯ŋnan
มันดูเป็นสิ่งที่เข้าใจยากหน่อยที่ใครสักคนจะเลือกรถหลังเต่าบีเทิลมากกว่ารถปอร์เช่|manduːpeːnsiŋatʰiːkʰeːaːt͡ɕajjaːkhanɔːjtʰiːkʰajrasakkʰanat͡ɕalɯːa̯kratʰohlaŋateːaːbiːtʰɤnmaːkokwaːrotpɔːt͡ɕʰeː
มันตอบอย่างเคร่งขรึม|mantɔːbɔːjaːŋkʰeːroŋkʰrɯm
มันตั้งอยู่ห่างออกไปห้าร้อยไมล์ทางตะวันออกเฉียงใต้ตามหลักภูมิศาสตร์|mantaŋɔːjuːhaːŋʔɔːkapajhaːrɔːjmajtʰaːŋtawanʔɔːkat͡ɕʰiːa̯ŋtajtaːmhalakpʰuːmisaːsot
มันต้องเป็นทั้งฉันหรือราชาแดง|mantɔːŋapeːntʰaŋat͡ɕʰanharɯːɔːraːt͡ɕʰaːdɛːŋ
มันทำให้ฉันโมโห|mantʰaำhajt͡ɕʰanmoːhoː
มันปรากฏที่นั่นอย่างไร|manpraːktatʰiːnanɔːjaːŋraj
มันมีชีวิตอยู่หรือไม่|manmiːt͡ɕʰiːwitɔːjuːhrɯːɔːmaj
มันมีต้นเกาลัดม้าหลากหลายตระกูล|manmiːtonkeːaːlatmaːhalaːkhalaːjtrakuːn
มันยังคงเป็นโลกที่สวยงาม|manjaŋokŋapeːnloːkatʰiːtwajaŋaːm
มันยังเช้าอยู่|manjaŋat͡ɕʰeːaːɔːjuː
มันยากที่จะลบหมึกสีน้ำเงินและแดง|manjaːkatʰiːt͡ɕanbahamɯksiːnaำŋɤnlɛdɛːŋ
มันสามารถเห็นได้ง่ายว่ากระดูกของเขาหักเมื่อดูผ่านเอ็กซเรย์|mansaːmaːntʰaheːndajŋaːjwaːkraduːkkʰɔːŋakʰeːaːhakmɯːa̯duːpʰaːnʔeːkotreː
มันสายไปแล้ว|mansaːjapajlɛːw
มันอยู่แค่สุดทางนั้น|manɔːjuːkʰɛːsuttʰaːŋanan
มันอาจจะเป็นไปไม่ได้สำหรับผู้เริ่มต้นที่จะกลายเป็นผู้นำ|manʔaːt͡ɕat͡ɕapeːnpajmajdajsaำharabpʰuːrɤmtanatʰiːt͡ɕaklaːjapeːnpʰuːnaำ
มันอาจจะไม่ได้แย่ไปกว่าที่เธอคาดไว้อีกเหรอ|manʔaːt͡ɕat͡ɕamajdajɛːpajkwaːtʰiːtʰɤːkʰaːtwajʔiːkheːrɔː
มันอาจมีผลการเคาะกลับได้|manʔaːt͡ɕamiːplakaːnkʰɔklabdaj
มันเคยอยู่ตรงนี้|mankʰeːjɔːjuːtraŋaniː
มันเป็นกฎข้อห้ามไม่ให้นักเรียนไปที่ห้องโถงใหญ่|manpeːnokdakʰɔːhaːmmajhajnakriːa̯napajtʰiːhɔːŋtʰoːŋahajjaʔ
มันเป็นคนทำรองเท้าบูทและรองเท้า|manpeːnoknatʰaำrɔːŋtʰeːaːbuːtlɛrɔːŋtʰeːaː
มันเป็นตุลาคมที่อบอุ่น|manpeːnatulaːkmatʰiːɔːbʔun
มันเป็นผ้าสีเขียวเขาพูดอย่างชาญฉลาด|manpeːnapʰaːsiːkʰiːa̯wkʰeːaːpʰuːdɔːjaːŋt͡ɕʰaːjotlaːt
มันเป็นวิดีโอสั้น|manpeːnawidiːʔoːsan
มันเป็นเวลาแปดโมงเช้าแล้ว|manpeːnaweːlaːpɛːtmoːŋat͡ɕʰeːaːlɛːw
มันเริ่มต้นจากน้ำชา|manrɤmotnat͡ɕaːknaำt͡ɕʰaː
มันเลยเป็นเรื่องพฤตินัยมากกว่านิตินัย|manleːjapeːnrɯːa̯ŋapʰaฤtinajmaːkokwaːnitinaj
มันเหมือนกับความสงบเยือกเย็น|manheːmɯːɔːnkabokwaːmotŋabajɯːa̯kjeːn
มันเหมือนโรคระบาดรุนแรง|manheːmɯːɔːnroːkʰrabaːtrunarɛːŋ
มันไม่จำเป็นต้องเป็นแบบนั้นเลยจริง|manmajt͡ɕaำpeːntɔːŋapeːnbɛːbananleːjotriŋ
มันไม่ใช่ของฉัน|manmajt͡ɕʰajkʰɔːŋt͡ɕʰan
มันไม่ใช่ความผิดของคุณที่ทำให้สมองของคุณบาดเจ็บ|manmajt͡ɕʰajkʰwaːmpʰidakʰɔːŋkʰunatʰiːtʰaำhajsamɔːŋkʰɔːŋakʰunbaːdat͡ɕeːb
มันไม่ใช่ว่าไม่มีศัตรูที่เราไม่จำเป็นต้องไปกังวลกับมัน|manmajt͡ɕʰajwaːmajmiːsatruːtʰiːreːaːmajt͡ɕaำpeːntɔːŋapajkaŋwalakabman
มัลติเทรดดิ้ง|mantitʰeːndadiŋ
มั่นใจคนไทยหนึ่งล้านไม่เอาทักษิณ|mant͡ɕajkʰontʰajhanɯŋlaːnamajʔeːaːtʰaksin
มาตลอด|maːtlɔːt
มาทำให้โลกนี้ดีขึ้นเถอะ|maːtʰaำhajloːkniːdiːkʰɯntʰeːʔaʔ
มานานแล้ว|maːnaːnlɛːw
มิสเตอร์บีนเป็นตัวละครหลักของหนังตลกอังกฤษ|mittɤːbiːnpeːnatuːa̯lakrahalakkʰɔːŋohnaŋotlakaʔaŋkaฤsaʔ
มิหลงใหลใครขอดู|mihlaŋahajlakʰajrakʰɔːduː
มีดอกไม้นานาพันธุ์ให้ชมมากมาย|miːdɔːkmajnaːnaːpʰantʰahajt͡ɕʰommaːkamaːj
มีระเบียง|miːrabiːa̯ŋ
มีสร้อยมุกหายไปเขาพูด|miːtrɔːjamukhaːjapajkʰeːaːpʰuːt
มีเพียงโอกาสเดียว|miːpʰiːa̯ŋʔoːkaːtdiːa̯w
มีใครคอยตรวจสอบบัญชีอยู่หรือไม่|miːkʰajrakʰɔːjtrowt͡ɕasɔːbbajat͡ɕʰiːɔːjuːhrɯːɔːmaj
มือถือเหรอ|mɯːɔːtʰɯːɔːheːrɔː
ยังมีข้อมูลอีกมากที่รอให้เราไปขุดค้น|jaŋmiːkʰɔːmuːnʔiːkamaːktʰiːrɔːhajreːaːpajkʰutkʰon
ยังเชื่อในสิ่งที่ทำ|jaŋt͡ɕʰɯːa̯najsiŋtʰiːtʰaำ
ยังไม่เที่ยงก็มีเรื่องปวดหัวแล้ว|jaŋmajtʰiːa̯ŋka็miːrɯːa̯ŋpawothuːa̯lɛːw
ยิงไปยิงมาจบแล้วง่ะ|jiŋpajiŋmaːt͡ɕoblɛːwaŋaʔ
ยิ่งคนสามารถเข้าถึงเว็บมากเท่าไร|jiŋkʰanasaːmaːntʰakʰeːaːtʰɯŋweːbamaːktʰeːaːraj
ยิ่งเร็วเร็วขึ้น|jiŋreːwareːwkʰɯn
ยี่สิบนาฬิกา|jiːsibnaːlikaː
ยุบพรรค|jubpʰrarok
ยุบเลิกจังหวัดหล่มศักดิ์|jublɤkat͡ɕaŋhawathalomsakot
ยูดาย|juːdaːj
รบกวนสอบถามเธอ|robkwonsɔːbatʰaːmtʰɤː
รวมร้านดัง|rowmaraːndaŋ
รวมเข้ากับจังหวัดเพชรบูรณ์|rowmakʰeːaːkabt͡ɕaŋohwadapʰeːtrabuːn
รวมเลือดเนื้อ|rowmalɯːa̯tnɯːa̯
รอยหยดหมึกแห้งอยู่บนหน้าที่ทำเสร็จแล้ว|rɔːjhajothamɯkhɛːŋɔːjuːbnahanaːtʰiːtʰaำseːra็t͡ɕalɛːw
ระบอบประชาธิปไตยที่มีพระมหากษัตริย์อยู่ภายใต้รัฐธรรมนูญ|rabɔːbprat͡ɕʰaːtʰiptajtʰiːmiːpramahaːksatriɔːjuːpʰaːjtajrattʰronmanuːj
ระบอบประชาธิปไตยอันมีพระมหากษัตริย์ทรงเป็นประมุข|rabɔːbprat͡ɕʰaːtʰiptajʔanmiːpʰramhaːkasatritʰonŋapeːnpramuk
รัฐบาลไทยร้องขอไปยังกูเกิลให้เอาวิดีโอที่วิพากษ์วิจารณ์กษัตริย์|ratbaːlatʰajrɔːŋkʰɔːpajaŋkuːkɤnhajʔeːaːwidiːʔoːtʰiːwipʰaːkwit͡ɕaːnkasatriʔ
ราคาถูกที่สุด|raːkʰaːtʰuːktʰiːsut
ราคาแผงเซลล์แสงอาทิตย์ถูกลงในหลายปีที่ผ่านมา|raːkʰaːpʰɛːŋseːlasɛːŋʔaːtʰittʰuːkonŋanajhalaːjpiːtʰiːpʰaːnmaː
รายการนั้นกว้างขวางอย่างน่ากลัว|raːjkaːranankwaːŋkʰwaːŋɔːjaːŋnaːkluːa̯
รายงานออกมาในแง่ลบเสียเป็นส่วนใหญ่|raːjŋaːnaʔɔːkmaːnajŋɛːnbasiːa̯peːnsawonhajjaʔ
ริชาร์ดกล่าว|rit͡ɕʰaːtklaːw
ริชาร์ดไม่ต้องการอะไรความเป็นเพื่อนที่มากไปกว่านี้|rit͡ɕʰaːtmajtɔːŋkaːraʔarajkʰwaːmpeːnapʰɯːa̯ntʰiːmaːkpajkwaːniː
รู้จักพืชเศรษฐกิจใหม่ที่มีประโยชน์ทางยา|ruːt͡ɕakpʰɯːt͡ɕʰaseːnsatʰakithajmatʰiːmiːprajoːttʰaːŋajaː
ลองถามหุ่นไล่กาดูสิ|lɔːŋtʰaːmahunlajkaːduːsiʔ
ลุงของฉันอาจไปตลาดหลานสาวของคุณ|luŋkʰɔːŋat͡ɕʰanʔaːt͡ɕapajtalaːthalaːnsaːwakʰɔːŋkʰun
ลุงเรียกเด็ก|luŋriːa̯kadeːk
ลูกชายของฉันเป็นผู้เชี่ยวชาญทางด้านแฟชั่นเขามีความภูมิใจและสนุก|luːkt͡ɕʰaːjakʰɔːŋt͡ɕʰanapeːnpʰuːt͡ɕʰiːa̯wt͡ɕʰaːjatʰaːŋdaːnafɛːt͡ɕʰankʰeːaːmiːkwaːmapʰuːmit͡ɕajlɛtnuk
ลูกรัก|luːkrak
วันนี้หุงข้าวกินกี่โมง|wanniːhuŋkʰaːwakinkiːmoːŋ
วันยุทธหัตถี|wanjutʰothatatʰiː
วันสมเด็จพระนเรศวรมหาราช|wansamadeːtpʰranreːsowramahaːraːt
วันหยุดชดเชย|wanhajutt͡ɕʰadat͡ɕʰeːj
วันหยุดนักขัตกฤษ์|wanhajutnakakʰatkaฤ
วันหยุดนั่งดูซีรีย์วนไป|wanhajutnaŋaduːsiːriːwnapaj
วันหยุดยาว|wanhajutjaːw
วันหยุดใหม่จะมา|wanhajuthajmat͡ɕamaː
วันอาทิตย์|wanʔaːtʰit
วันเกิดของเธอถัดจากวันคริสต์มาสไม่กี่วัน|wankɤdakʰɔːŋtʰɤːtʰatt͡ɕaːkwankʰritmaːsamajkiːwan
วัสดุอาจฉีกขาดได้หากดึงมากเกินไป|watduʔaːtt͡ɕʰiːkakʰaːtdajhaːkdɯŋamaːkkɤnapaj
วาดแผนภูมิด้วยเส้นทึบสีดำ|waːtpʰɛːnapʰuːmitwajaseːntʰɯbasiːdaำ
วิทยาลัยตัดสินใจที่จะลดแผนสำหรับการขยายพื้นที่จอดรถลง|witjaːlajtadasint͡ɕajtʰiːt͡ɕandapʰɛːnsaำharabkaːrokjaːjapʰɯːntʰiːt͡ɕɔːtratʰaloŋ
วิทยุ|witjuʔ
วิธีที่ดีในการแสดงการเปรียบเทียบคือผ่านเรื่องราว|witʰiːtʰiːdiːnajkaːnsɛːdoŋkaːrapeːriːjbatʰiːa̯bkʰɯːɔːpʰaːnrɯːa̯ŋaraːw
วิลเลียม|winliːa̯m
ว่านั่นมันจะทำให้ได้อะไรที่แตกต่างออกไปยังไง|waːnanmanat͡ɕatʰaำhajdajʔarajtʰiːtɛːktaːŋaʔɔːkpajaŋŋaj
ศิลป์|sin
ศูนย์บริการเช่ารถเป็นสถานที่ที่เหมาะกับการเช่ารถ|suːnbarikaːnt͡ɕʰeːaːntʰapeːnsatʰaːntʰiːtʰiːheːmaːakabkaːrat͡ɕʰeːaːrot
สดใสเป็นความรู้สึกโดยสัญชาตญาณเมื่อพวกเขามาอยู่ด้วยกัน|sotsajpeːnkʰwaːmruːsɯkdoːjasajt͡ɕʰaːtajaːnmɯːa̯pʰowkakʰeːaːmaːɔːjuːtwajakan
สติ๊กเกอร์นั้นกำลังหลุดลอกจากของ|satikkɤːnankaำlaŋhalutlɔːkat͡ɕaːkkʰɔːŋ
สถิติการระงับการเข้าถึงเว็บไซต์และการดำเนินคดี|satʰitikaːnraŋabkaːrakʰeːaːtʰɯŋweːbasajlɛkaːndaำnɤnkʰadiː
สมมติว่าเขาอยู่ไหนที่ซุ่มซ่อน|sommatiwaːkʰeːaːɔːjuːhajnatʰiːsumsɔːn
สมัยนี้หาตู้เอทีเอ็มยากมาก|samajniːhaːtuːʔeːtʰiːʔeːmjaːkamaːk
สหภาพแห่งสหพันธ์นักศึกษาพม่า|sohpʰaːpʰahɛːŋsahapʰannakasɯksaːpʰamaː
สองพันห้าร้อยแรงม้า|sɔːŋpʰanahaːrɔːjrɛːŋamaː
สองร้อยสามสิบหก|sɔːŋrɔːjasaːmsibahok
สัตว์ไม่ได้มีความเข้าใจในเรื่องฟิสิกส์พวกมันจึงกล้าที่จะเสี่ยงกับผลลัพธ์ที่เกิดจากการจับปลา|satmajdajmiːkwaːmakʰeːaːt͡ɕajnajrɯːa̯ŋfisikpʰawokmanat͡ɕɯŋklaːtʰiːt͡ɕasiːa̯ŋkaboplalaptʰiːkɤtt͡ɕaːkakaːnt͡ɕaboplaː
สัมผัสได้ถึงความสยองขวัญ|sampʰasadajtʰɯŋkʰwaːmsajɔːŋkʰwaj
สาธารณรัฐสยาม|saːtʰaːnnaratsajaːm
สามทุ่ม|saːmtʰum
สำหรับคุณ|saำharabkʰun
สิบปีก่อนครับ|sibpiːkɔːnkʰrab
สิบเก้านาฬิกา|sibkeːaːnaːlikaː
สิ่งของที่คนเกือบทุกคนใช้กันอยู่เกือบทุกวัน|siŋkʰɔːŋatʰiːknakɯːa̯btʰukoknat͡ɕʰajkanɔːjuːkɯːa̯btʰukwan
สิ่งต่าง|siŋtaːŋ
สิ่งสุดท้ายของชาวยิว|siŋsudatʰaːjkʰɔːŋat͡ɕʰaːwjiw
สุขสันต์วันคริสต์มาสนะทุกคน|suksanawankʰritmaːsanatʰukkʰon
ส่งมาให้ฉัน|soŋmaːhajt͡ɕʰan
หนอนตัวที่มาก่อนจะถูกจับก่อน|hanɔːntuːa̯tʰiːmaːkɔːnt͡ɕatʰuːkt͡ɕabakɔːn
หนึ่งหมื่นสองพันสามร้อยสี่สิบห้าจุดหกเจ็ดแปดเก้า|hanɯŋhamɯːnsɔːŋapʰansaːmarɔːjsiːsibhaːt͡ɕuthakat͡ɕeːtpɛːdakeːaː
หน่วยความจำทำให้เด็กนักเรียนกลัว|honwajokwaːmat͡ɕaำtʰaำhajdeːknakriːa̯nkluːa̯
หมอผิวหนังของฉันแนะนำว่าฉันควรหยุดล้างมือด้วยน้ำเดือด|hamɔːpʰiwhanaŋkʰɔːŋat͡ɕʰannɛnaำwaːt͡ɕʰankʰwonhajutlaːŋamɯːɔːtwajanaำdɯːa̯t
หมากัดดีกว่าหมาเห่า|hamaːkatdiːkwaːhmaːheːaː
หมายถึงแบบ|hamaːjtʰɯŋabɛːb
หมูแผ่นรสชาติดีมากแต่ศาสนาของเราไม่อนุญาติให้เราทานมัน|hamuːpʰɛːnrasat͡ɕʰaːtidiːmaːktɛːsaːtnaːkʰɔːŋreːaːmajɔːnujaːtihajreːaːtʰaːnman
หยุดยาว|hajutjaːw
หรือข้อความที่ทำให้ปรากฏ|harɯːɔːkʰɔːkwaːmatʰiːtʰaำhajpraːkot
หรือสุขใจ|harɯːɔːsukt͡ɕaj
หลังจากการทดลองและข้อผิดพลาดเขาได้รับวิธีการแก้ไขแล้ว|halaŋt͡ɕaːkakaːntʰadalɔːŋlɛkʰɔːpʰitpʰlaːtkʰeːaːdajrabwitʰiːkaːnkɛːkʰajlɛːw
หลังจากที่ซื้อผ้าเช็ดตัว|halaŋt͡ɕaːkatʰiːsɯːɔːpʰaːt͡ɕʰeːttuːa̯
หลังจากอาการหัวหมุนหยุดลง|halaŋt͡ɕaːkaʔaːkaːnhuːa̯hamunhajutloŋ
หลังจากโฆษณาไวน์แล้วเขาก็ขายน้ำส้ม|halaŋt͡ɕaːkakʰoːtnaːwajlɛːwkʰeːaːka็kʰaːjnaำsom
หลังอาบน้ำเสร็จแล้วโกนหนวดเลยก็น่าจะไม่เลว|halaŋʔaːbanaำseːra็t͡ɕalɛːwkoːnohnawotleːjaka็naːt͡ɕamajleːw
หลายเชื้อชาติ|halaːjt͡ɕʰɯːa̯t͡ɕʰaːtiʔ
หลายเผ่าพันธุ์ร่วมอยู่|halaːjpʰeːaːpʰantʰrowmɔːjuː
หัวขวาขุนสามชนเกลื่อนเข้า|huːa̯kwaːkʰunsaːmotnakeːlɯːɔːnkʰeːaː
หากคุณจะหาแฟนได้เร็วก่อน|haːkkʰunat͡ɕahaːfɛːndajreːwkɔːn
หากมีภาระหนี้สินอย่างไรก็จะผ่านด่านได้|haːkmiːpʰaːrahniːsinɔːjaːŋrajka็t͡ɕapʰaːndaːnadaj
หางานพิเศษ|haːŋaːnpʰiseːt
หุบปากของเธอซะ|hubpaːkakʰɔːŋtʰɤːsaʔ
หุ่นขี้ผึ้งเหล่านี้ดูน่าขยะแขยง|hunkʰiːpʰɯŋheːlaːniːduːnaːkjakʰɛːjoŋ
หูฟังไร้สาย|huːfaŋrajsaːj
ห้องนั้นอยู่ตรงข้ามซีเลีย|hɔːŋnanɔːjuːtraŋakʰaːmsiːliːa̯
ห้องปฏิบัติการปัญญาประดิษฐ์|hɔːŋpatibatikaːnpajajaːpradit
ห้ามพลาด|haːmpʰlaːt
อดทนแล้วจะประสบความสำเร็จ|ɔːttʰanalɛːwt͡ɕapratbokʰwaːmsaำreːt
อดีตนายกเทศมนตรีกำลังกล่าวสุนทรพจน์ในวันศุกร์|ɔːdiːtnaːjoktʰeːsomnotriːkaำlaŋklaːwsunotrapʰotnajwansuk
อดีตรัฐมนตรีว่าการกระทรวงศึกษาธิการ|ɔːdiːtratʰomnotriːwaːkaːnkratrawoŋsɯkasaːtʰikaːn
อยู่เสมอ|ɔːjuːseːmɔː
อยู่ในบ้านหลังนี้|ɔːjuːnajbaːnhalaŋniː
อย่ากดปุ่มสีแดง|ɔːjaːkdapumsiːdɛːŋ
อย่างแท้จริง|ɔːjaːŋtʰɛːt͡ɕariŋ
อย่างไรก็ตาม|ɔːjaːŋrajka็taːm
อย่างไหนที่คุณชอบที่จะเลือกมากกว่า|ɔːjaːŋhajnatʰiːkʰunt͡ɕʰɔːbatʰiːt͡ɕalɯːa̯kmaːkokwaː
อย่าปล่อยออกมาให้นักเขียนถูกด่า|ɔːjaːplɔːjaʔɔːkmaːhajnakkʰiːa̯natʰuːkdaː
อลิซกล่าว|ɔːlitklaːw
อลิซกับบ็อบอัธยาศัยดีมาก|ɔːlitkababa็ɔːbʔatʰajaːsajdiːmaːk
อลิซหันกลับ|ɔːlithanoklab
อลิสไตร่ตรอง|ɔːlittajrotrɔːŋ
อสังหาริมทรัพย์ในชนบท|ɔːsaŋhaːrimtʰrapnajt͡ɕʰonbot
ออกจากยูทูบ|ʔɔːkt͡ɕaːkajuːtʰuːb
ออกแถลงการณ์สนับสนุนการเรียกร้องประชาธิปไตยไทย|ʔɔːktʰɛːloŋkaːrotnabotnunakaːnriːa̯krɔːŋprat͡ɕʰaːtʰiptajtʰaj
ออเนส|ʔɔːneːt
อะไรคือท่าทางจุดยืนของคุณ|ʔarajkʰɯːɔːtʰaːtʰaːŋt͡ɕudajɯːnkʰɔːŋakʰun
อะไรนักหนาวะ|ʔarajnakhanaːwaʔ
อังกฤษนี่ไปเน้นประตูกันควันไฟกับปลั๊กที่มีฟิวส์มากกว่า|ʔaŋkaฤsaniːpajneːnpratuːkankʰwanfajkabplaktʰiːmiːfiwmaːkokwaː
อันนี้เป็นการตั้งชื่อได้น่ารัก|ʔanniːpeːnkaːrataŋt͡ɕʰɯːɔːdajnaːrak
อันไหนอ่ะ|ʔanhajnaʔaʔ
อาการเจ็บป่วยที่ไม่ได้รับการรักษาอาจทำให้เกิดการเรื้อรัง|ʔaːkaːnt͡ɕeːbopwajatʰiːmajdajrabkaːraraksaːʔaːttʰaำhajkɤtkaːrarɯːa̯raŋ
อาจมีสัตว์ป่าในป่าในขณะนี้โดโรธีกล่าว|ʔaːtmiːsatpaːnajpaːnajkʰananiːdoːroːtʰiːklaːw
อาจอยู่ในกลุ่มมากกว่าหนึ่งกลุ่ม|ʔaːt͡ɕɔːjuːnajklummaːkokwaːhanɯŋklum
อาชญากรสบประมาทเจ้าหน้าที่ตำรวจและผู้คุมคุก|ʔaːtjaːkonsabopramaːtt͡ɕeːaːhnaːtʰiːtaำrowt͡ɕalɛpʰuːkʰumkʰuk
อายุหรือการเปลี่ยนแปลงไม่ควรเหี่ยวเฉา|ʔaːjuhrɯːɔːkaːnpeːliːjnapɛːnŋamajkʰwrahiːa̯wt͡ɕʰeːaː
อาหารชาววัง|ʔaːhaːnt͡ɕʰaːwawaŋ
อาหารมากเกินไปกำลังถูกทำลาย|ʔaːhaːnmaːkakɤnpajkaำlaŋtʰuːkatʰaำlaːj
อาเม็ดไม่ได้โน้มน้าวใจผู้พัฒนา|ʔaːmeːtmajdajnoːmnaːwat͡ɕajpʰuːpʰatnaː
อินเตอร์เน็ตและโลกจะดียิ่งขึ้น|ʔintɤːneːtlɛloːkt͡ɕadiːjiŋkʰɯn
อินไลน์สเก็ตเหมือนกับสเต็กน้ำแข็ง|ʔinlajsakeːtheːmɯːɔːnkabotteːkanaำkʰɛː็ŋaʔ
อืม|ʔɯːm
อืมม|ʔɯːmom
อเดลมีเจตนาที่จะทำให้เรื่องของเธอปลอดภัย|ɔːdeːnmiːt͡ɕeːtnaːtʰiːt͡ɕatʰaำhajrɯːa̯ŋkʰɔːŋatʰɤːplɔːdapʰaj
อ่า|ʔaː
อ้วนแล้วกอดอุ่นนะครับ|ɔːwnalɛːwkɔːdaʔunnakʰrab
อ้าว|ʔaːw
ฮัมตี้|hamtiː
ฮัมตี้ดัมตี้กล่าว|hamtiːdamtiːklaːw
เก็บน้ำยาซักผ้าให้ห่างจากเด็ก|keːbnaำjaːsakpʰaːhajhaːŋt͡ɕaːkadeːk
เขากำลังจะวางกุญแจบนขอบหน้าต่างห้องครัว|kʰeːaːkaำlaŋt͡ɕawaːŋkujat͡ɕɛːbnakʰɔːbhanaːtaːŋhɔːŋokruːa̯
เขากำลังนอนราบอยู่|kʰeːaːkaำlaŋnɔːnaraːbɔːjuː
เขาก็ไม่ได้จับนกฮูกตัวใหญ่ในป่า|kʰeːaːka็majdajt͡ɕabnakahuːktuːa̯hajjanajpaː
เขาค่อย|kʰeːaːkʰɔːj
เขาจะอยู่ในระยะกระจายของมัน|kʰeːaːt͡ɕaɔːjuːnajrajakrat͡ɕaːjkʰɔːŋaman
เขาต้องคอยรับผิดชอบทุกสิ่งที่อยู่ต่อหน้าเขา|kʰeːaːtɔːŋkʰɔːjarabpʰidat͡ɕʰɔːbtʰukasiŋtʰiːɔːjuːtɔːhnaːkʰeːaː
เขาต้องมีส่วนรู้เห็นกับอาชญากรรมนี้แน่|kʰeːaːtɔːŋmiːsownaruːheːnkabaʔaːtjaːkonramaniːnɛː
เขาทุบโต๊ะ|kʰeːaːtʰubtoʔ
เขาผู้ที่มีความกระตือรือร้น|kʰeːaːpʰuːtʰiːmiːkwaːmokratɯːɔːrɯːɔːron
เขาพูด|kʰeːaːpʰuːt
เขาพูดบางอย่างเกี่ยวกับแผนการของฉันที่ฉันยังไม่เข้าใจ|kʰeːaːpʰuːtbaːŋɔːjaːŋkiːa̯wakabpʰɛːnakaːnkʰɔːŋat͡ɕʰantʰiːt͡ɕʰanjaŋamajkʰeːaːt͡ɕaj
เขาพูดประโยคเดิมนี้มาสามสิบรอบแล้ว|kʰeːaːpʰuːtprajoːkdɤmaniːmaːsaːmsibarɔːblɛːw
เขาพูดหน้าตาเฉย|kʰeːaːpʰuːthanaːtaːt͡ɕʰeːj
เขามีไขมันอุดตันในเส้นเลือด|kʰeːaːmiːkʰajmanʔudatannajseːnlɯːa̯t
เขาลบตารางห้าตารางออกจากฐานข้อมูล|kʰeːaːnbataːraːŋhaːtaːraːŋʔɔːkat͡ɕaːktʰaːnakʰɔːmuːn
เขาลื่นตกบันได|kʰeːaːlɯːntakabandaj
เขาลุกขึ้นพร้อมกับกระตุก|kʰeːaːlukkʰɯnoprɔːmakabkratuk
เขาหายไปเต้น|kʰeːaːhaːjpajteːn
เขาเขย่าลูกบิดประตูด้วยความรู้สึกผิด|kʰeːaːkʰeːjaːluːkbidopratuːtwajokwaːmaruːsɯkpʰit
เขาเจาะหูไม่เหมือนใคร|kʰeːaːt͡ɕɔhuːmajheːmɯːɔːnkʰajraʔ
เขาเป็นคนพึ่งพาอะไรไม่ได้หรอก|kʰeːaːpeːnkʰanapʰɯŋpʰaːʔarajmajdajharɔːk
เขาเป็นลูกแท้|kʰeːaːpeːnluːkatʰɛː
เขาใช้เวลาสั้น|kʰeːaːt͡ɕʰajweːlaːsan
เขาได้ตอบกลับมา|kʰeːaːdajtɔːbklabmaː
เขาไม่ได้เป็นมากกว่าหนึ่งในเครื่องดนตรี|kʰeːaːmajdajpeːnmaːkokwaːhanɯŋnajkʰeːrɯːɔːŋdanotriː
เคยคุมกำเนิดแบบไหน|kʰeːjkʰumakaำnɤtbɛːbahajnaʔ
เคราดำ|kʰeːraːdaำ
เคราน้ำเงิน|kʰeːraːnaำŋɤn
เครื่องกลึงจะตัดแต่งชิ้นไม้ได้|kʰeːrɯːɔːŋklɯŋt͡ɕatattɛːŋat͡ɕʰinmajdaj
เคร่งศาสนา|kʰeːnŋasaːtnaː
เจอคนนี้ครั้งแรกรู้สึกยังไง|t͡ɕɤːknaniːkraŋarɛːkruːsɯkjaŋaŋaj
เจ้าของซอฟแวร์ใช้ฟังชั่น|t͡ɕeːaːkʰɔːŋsɔːfawɛːt͡ɕʰajfaŋt͡ɕʰan
เจ้าหน้าที่อุทยานมาช่วยไล่ช้าง|t͡ɕeːaːhnaːtʰiːʔutjaːnamaːtwajalajt͡ɕʰaːŋ
เจ้าเมืองบ่เอาจกอบในไพร่ลู่ทาง|t͡ɕeːaːmɯːa̯ŋbaʔeːaːtkɔːbanajpʰajraluːtʰaːŋ
เจ้าแมวน้อย|t͡ɕeːaːmɛːwnɔːj
เช่นสลัดเคราแดง|t͡ɕʰeːnsalatkʰeːraːdɛːŋ
เช่นเดียวกับสองถั่ว|t͡ɕʰeːndiːa̯wakabsɔːŋatʰuːa̯
เช้าแล้ว|t͡ɕʰeːaːlɛːw
เดนนิสไม่สามารถเข้าใกล้เสาหินนั้นได้|deːnnisamajsaːmaːntʰakʰeːaːkajlaseːaːhinnanadaj
เดลิเวอรี|deːliwɤːriː
เดอะมอลล์เปิดเวลาแปดโมงครึ่งถึงห้าโมงเย็น|deːʔamɔːnpɤdaweːlaːpɛːtmoːŋokrɯŋatʰɯŋhaːmoːŋjeːn
เดินให้มันดี|dɤnhajmandiː
เดี๋ยวก่อน|diːa̯wkɔːn
เดือนมกราคมตามเดือนธันวาคมมาอย่างรวดเร็ว|dɯːa̯nmokraːkmataːmdɯːa̯natʰanwaːkʰommaːɔːjaːŋrawotreːw
เด็กทารกก็มาจากเว็บอเมซอนไงล่ะ|deːktʰaːrokka็maːt͡ɕaːkweːbɔːmeːsɔːnŋajlaʔ
เด็กเด็กทั้งหมดอยากสัมผัสขนยูนิคอร์น|deːkdeːkatʰaŋhamadɔːjaːksamapʰatkʰanajuːnikʰɔːn
เตรียมตัวสำหรับปิกนิกกันเถอะ|teːriːjmatuːa̯saำharabpikanikkanatʰeːʔaʔ
เทิร์น|tʰɤn
เธอกล้าถาม|tʰɤːklaːtʰaːm
เธอกำลังติดเชื้อไข้หวัดใหญ่|tʰɤːkaำlaŋtidat͡ɕʰɯːa̯kʰajhawathajjaʔ
เธอต้องเอามา|tʰɤːtɔːŋʔeːaːmaː
เธอถามขึ้น|tʰɤːtʰaːmkʰɯn
เธอพูด|tʰɤːpʰuːt
เธอพูดแบบนั้น|tʰɤːpʰuːtbɛːbanan
เธอเป็นช่างถักที่วิเศษมาก|tʰɤːpeːnt͡ɕʰaːŋatʰaktʰiːwiseːtmaːk
เธอแต่งงานแล้ว|tʰɤːtɛːŋŋaːnalɛːw
เธอไม่ได้อยู่ที่นี่|tʰɤːmajdajɔːjuːtʰiːniː
เนื่องจากการขาดโปรแกรมความผิดพลาด|nɯːa̯ŋt͡ɕaːkakaːnkʰaːdapoːnkɛːromkʰwaːmpʰidoplaːt
เปลือกข้าวโพดสามารถใช้จุดไฟ|peːlɯːɔːkkʰaːwapʰoːtsaːmaːntʰat͡ɕʰajt͡ɕutfaj
เป็นคนที่มีอารมณ์ขันมาก|peːnkʰanatʰiːmiːʔaːnmakʰanmaːk
เป็นความเร็วที่ใกล้จะจบ|peːnkʰwaːmreːwatʰiːkajlat͡ɕat͡ɕob
เป็นนักต่อสู้และนักแสดงชื่อดังจากฮ่องกง|peːnnakatɔːsuːlɛnaksɛːdoŋt͡ɕʰɯːɔːdaŋt͡ɕaːkahɔːŋkoŋ
เป็นประชาราษฏร์|peːnprat͡ɕʰaːraːsot
เป็นราชาแห่งปลาเค็ม|peːnraːt͡ɕʰaːhɛːŋplaːkʰeːm
เป็นโอกาสดีที่จะมาเป็นผู้ประกอบการ|peːnʔoːkaːtdiːtʰiːt͡ɕamaːpeːnpʰuːprakɔːbkaːn
เพราะว่าเราคือเพื่อนแท้|pʰeːraːawaːreːaːkʰɯːɔːpʰɯːa̯ntʰɛː
เพราะอย่างนี้หล่อนจึงไม่เดิน|pʰeːraːaɔːjaːŋniːhalɔːnt͡ɕɯŋamajdɤn
เพราะไม่จำเป็นต้องมีมาตรฐานกำกับ|pʰeːraːamajt͡ɕaำpeːntɔːŋamiːmaːtratʰaːnkaำkab
เพลงประ่เทศกูมีเป็นเพลงเสียดสีสังคมไทย|pʰeːnŋopratʰeːtkuːmiːpeːnpʰeːloŋsiːa̯dasiːsaŋkʰamatʰaj
เพลย์ลิสต์ใหม่บนสปอตติฟาย|pʰeːnlisahajmobnasapɔːttifaːj
เพียงแต่ขยับตัวก็พอแล้ว|pʰiːa̯ŋtɛːkʰajabtuːa̯ka็pʰɔːlɛːw
เพื่อตรวจหาสิ่งมีชีวิตบนดาวอังคาร|pʰɯːa̯trawothaːsiŋmiːt͡ɕʰiːwitbanadaːwʔaŋakʰaːn
เพื่อนบอก|pʰɯːa̯nbɔːk
เพื่อนบ้านของฉันเลี้ยงสุนัขอัลเซเชียนและมันวิ่งได้เร็วมาก|pʰɯːa̯nbaːnakʰɔːŋt͡ɕʰanaliːa̯ŋsunakʔalaseːt͡ɕʰiːa̯nlɛmanwiŋadajreːwmaːk
เพื่อนรัก|pʰɯːa̯nrak
เพื่อเป็นสื่อกลางในแต่ละขั้นตอน|pʰɯːa̯peːnsɯːɔːklaːŋanajtɛːlakʰantɔːn
เฟต้าชีสเผ็ด|feːtaːt͡ɕʰiːtpʰeːt
เฟรเดอริค|feːndɤːrik
เมื่อคืนนี้|mɯːa̯kʰɯːnniː
เมื่อคืนนี้เจ้าหน้าที่ของรัฐบาลดื่มฉลองให้กับการมีอำนาจอธิปไตยทางการคลัง|mɯːa̯kʰɯːnniːt͡ɕeːaːhnaːtʰiːkʰɔːŋratʰabaːndɯːmotlɔːŋahajkabkaːramiːɔːำnaːt͡ɕɔːtʰiptajtʰaːŋkaːroklaŋ
เมื่อแอปเปิ้ลเข้ามาทำให้หมอต้องออกไป|meːɯːʔɔːɛːppɤlakʰeːaːmaːtʰaำhajhamɔːtɔːŋʔɔːkapaj
เมแกนก็รู้สึกดีขึ้น|meːkɛːnka็ruːsɯkdiːkʰɯn
เราก็ได้เห็นแล้วว่า|reːaːka็dajheːnlɛːwawaː
เราควรได้รับผลกระทบจากการให้บริการสังคมของเราอย่างต่อเนื่อง|reːaːkwaradajrabpʰlokratʰobt͡ɕaːkakaːnhajbarikaːnsaŋokmakʰɔːŋreːaːɔːjaːŋtɔːnɯːa̯ŋ
เราจะได้เห็นเขาชี้ไปที่งานไม้|reːaːt͡ɕadajheːnkʰeːaːt͡ɕʰiːpajtʰiːŋaːnmaj
เราต้องทำหรือไม่|reːaːtɔːŋtʰaำharɯːɔːmaj
เราถามเผื่อว่าจะเคยเป็นเพื่อนของริชาร์ด|reːaːtʰaːmpʰɯːa̯waːt͡ɕakʰeːjpeːnapʰɯːa̯nkʰɔːŋarit͡ɕʰaːt
เราทั้งหมดรู้สึกตื่นตระหนกอย่างท่วมท้นกับสัญญาณเตือนถึงเหตุการณ์ร้ายที่กำลังจะมาถึง|reːaːtʰaŋhamotruːsɯktɯːnotrahonkɔːjaːŋtʰawomtʰanakabsajajaːntɯːa̯natʰɯŋheːtukaːnraːjatʰiːkaำlaŋt͡ɕamaːtʰɯŋ
เราทำอาหารไม่เป็นเลย|reːaːtʰaำʔaːhaːnmajpeːnleːj
เราหาถนนใหญ่ไม่เจอ|reːaːhaːtnanahajjamajt͡ɕɤː
เราเจอกันตรงไหนดี|reːaːt͡ɕɤːkantroŋhajnadiː
เราแทบจะไม่ได้ยินเสียงตัวเองพูด|reːaːtʰɛːbt͡ɕamajdajinsiːa̯ŋatuːa̯ʔeːŋpʰuːt
เราใช้เวลาสองสามชั่วโมง|reːaːt͡ɕʰajweːlaːsɔːŋsaːmat͡ɕʰuːa̯moːŋ
เราไม่มีอะไรที่ต้องทำกันแล้ว|reːaːmajmiːʔarajtʰiːtɔːŋtʰaำkanlɛːw
เรียกร้องคณะกรรมการอิสระค้นหาข้อเท็จจริง|riːa̯krɔːŋoknakonramakaːnʔisaraknahaːkʰɔːtʰeːtt͡ɕariŋ
เรียกสเปด|riːa̯ksapeːt
เรียนรู้|riːa̯nruː
เรื่องร้ายจะกลายเป็นดี|rɯːa̯ŋraːjat͡ɕaklaːjapeːndiː
เรื่องอื้อฉาวของฝรั่งเศสเลวร้ายยิ่งกว่าไม่มี|rɯːa̯ŋʔɯːɔːt͡ɕʰaːwkʰɔːŋofraŋaseːtleːwaraːjjiŋokwaːmajmiː
เล่นเกมอื่นได้ไหม|leːnkeːmaʔɯːndajhajmaʔ
เสวนา|seːwnaː
เสียงของเขาในหนหนึ่งนั้นก็แสดงถึงความกล้าหาญ|siːa̯ŋkʰɔːŋakʰeːaːnajhonhanɯŋnanaka็sɛːtŋatʰɯŋkʰwaːmklaːhaːj
เสียงแทมเบอรีนก็ดังกุ๊งกิ๊ง|siːa̯ŋtʰɛːmabɤːriːnka็daŋkuŋakiŋ
เสียใจจนพูดไม่ออก|siːa̯t͡ɕajt͡ɕonpʰuːdamajʔɔːk
เสื้อเหลือง|sɯːa̯heːlɯːɔːŋ
เหล็กจำนวนมากอยู่ในกองไฟ|heːla็kat͡ɕaำnownamaːkɔːjuːnajkɔːŋfaj
เห็นอันนี้แล้วใช่ป่ะ|heːnʔananiːlɛːwt͡ɕʰajpaʔ
เอด้า|ʔeːdaː
เอลีนรักษาหน้าหลุมศพและให้เกียรติ|ʔeːliːnrakasaːhnaːhalumsopʰlɛhajkiːa̯ntiʔ
เอาล่ะตอนนี้ส่งคืนทหารม้า|ʔeːaːlatɔːnniːsoŋkʰɯːnothaːramaː
เอ้า|ʔeːaː
แกงเขียวหวาน|kɛːŋkʰiːa̯wohwaːn
แค่รู้สึกว่ามันเยอะไปหน่อย|kʰɛːruːsɯkwaːmanjeːʔapajhanɔːj
แค่โอกาสเดียวที่จะรักษาเจนได้|kʰɛːʔoːkaːtdiːa̯watʰiːt͡ɕaraksaːt͡ɕeːndaj
แค่ให้เวลาฉันอีกหน่อย|kʰɛːhajweːlaːt͡ɕʰanʔiːkohnɔːj
แจ็คกี้|t͡ɕɛː็kʰakiː
แชมป์จะเป็นของเรา|t͡ɕʰɛːmt͡ɕapeːnkʰɔːŋareːaː
แตะเพื่อออก|tɛpʰeːɯːʔɔːɔːk
แต่ก็เป็นอีกครั้ง|tɛːka็peːnʔiːkokraŋ
แต่คุณพาพวกเขามานี่ได้นะ|tɛːkʰunpʰaːpʰowkakʰeːaːmaːniːdajnaʔ
แต่จงอย่ายอมให้สิ่งนี้บดบังสายตาคุณว่ามีคุณธรรมใดอยู่|tɛːtŋɔːjaːjɔːmhajsiŋniːbotbaŋasaːjtaːkʰunwaːmiːkʰuntʰronmadajɔːjuː
แต่ต่างกันที่ใช้ล้อแทนใบมีด|tɛːtaːŋkanatʰiːt͡ɕʰajlɔːtʰɛːnbajmiːt
แต่ประมาณบ่ายสาม|tɛːpramaːnbaːjasaːm
แต่มักได้ใช้จ่ายกับงานการกุศล|tɛːmakdajt͡ɕʰajt͡ɕaːjkabaŋaːnkaːrakuson
แต่มันก็คือสองอย่างในหนึ่งเดียว|tɛːmanka็kʰɯːɔːsɔːŋɔːjaːŋnajhanɯŋdiːa̯w
แต่มันก็สายเกินไป|tɛːmanka็saːjkɤnapaj
แต่มันคือโชคร้ายที่แย่มาก|tɛːmankʰɯːɔːt͡ɕʰoːkraːjatʰiːjɛːmaːk
แต่มันดีมากพอสำหรับเวลานี้|tɛːmandiːmaːkpʰɔːsaำharabweːlaːniː
แต่มันไม่มีเลย|tɛːmanmajmiːleːj
แต่มันไม่ใช่ฉันที่ชมตัวเองว่าฉลาด|tɛːmanmajt͡ɕʰajt͡ɕʰantʰiːt͡ɕʰomtuːa̯ʔeːŋwaːt͡ɕʰalaːt
แต่ยังรักวันหยุดเก่า|tɛːjaŋrakwanhajutkeːaː
แต่เขาก็มองไม่เห็นอะไรที่ดูผิดปกติเลย|tɛːkʰeːaːka็mɔːŋmajheːnʔarajtʰiːduːpʰitpakatileːj
แต่เขาไม่เคยดูแลเขาเลย|tɛːkʰeːaːmajkʰeːjduːlɛːkʰeːaːleːj
แต่เรายังไม่เคยเข้าใกล้มันได้เลย|tɛːreːaːjaŋmajkʰeːjkʰeːaːkajlamandajleːj
แต่ในขณะเดียวกัน|tɛːnajkʰanadiːa̯wkan
แถมฝรั่งก็นิยมสวมแหวนแต่งงานนิ้วนี้|tʰɛːmfaraŋka็nijmasowmahɛːwnatɛːŋŋaːnaniwniː
แถวนี้มีกล่องจดหมายใกล้|tʰɛːwniːmiːklɔːŋotdahamaːjkajlaʔ
แบบฟอร์มเป็นไปตามฟังก์ชั่น|bɛːbfɔːmapeːnpajtaːmfaŋat͡ɕʰan
แปดสิบเซนต์|pɛːtsibaseːn
แป้นเบรคกำลังสั่นในขณะที่ระบบป้องกันการลื่นเข้ามาทำงาน|pɛːnbeːrokkaำlaŋsananajkʰanatʰiːrabbapɔːŋkanakaːnlɯːnakʰeːaːmaːtʰaำŋaːn
แผงกั้นพลาสติกแตกละเอียด|pʰɛːŋkanoplaːsatiktɛːklaʔiːa̯t
แฟกซ์|fɛːk
แมรี่ต่อสู้ก่อนที่เธอจะหลับ|mɛːriːtɔːsuːkɔːntʰiːtʰɤːt͡ɕahlab
แมรี่หลอมรวมแนวคิดจากการระดมสมองในแผนของเธอ|mɛːriːhlɔːmonwamanɛːwkʰidat͡ɕaːkkaːraratmasamɔːŋnajpʰɛːnkʰɔːŋatʰɤː
แม่ที่ดีของฉันอยู่ต่างจังหวัด|mɛːtʰiːdiːkʰɔːŋt͡ɕʰanɔːjuːtaːŋt͡ɕaŋohwat
แม่ไปซื้อผ้าและตัดผมที่ตลาด|mɛːpajsɯːɔːpʰaːlɛtatpʰamatʰiːtlaːt
แรงแซงทุกโค้งแน่นอน|rɛːŋsɛːŋatʰukkʰoːŋanɛːnɔːn
และคุณคิดว่าคุณวู้ดคอร์ทจะมีทริปล่องเรืออีกมั้ย|lɛkʰunkʰidawaːkʰunwuːdakʰɔːtt͡ɕamiːtriplɔːŋreːɯːʔɔːiːkmaj
และฉันก็เพิ่มสิ่งที่ฉันมีมากมายลงไปในจำนวนที่เท่ากัน|lɛt͡ɕʰanka็pʰɤmsiŋatʰiːt͡ɕʰanmiːmaːkmaːjonŋapajnajt͡ɕaำnownatʰiːtʰeːaːkan
และฉันก็เหมือนกัน|lɛt͡ɕʰanka็heːmɯːɔːnkan
และฉันจะชำระได้ด้วยวิธีใด|lɛt͡ɕʰant͡ɕat͡ɕʰaำradajdowjawitʰiːdaj
และฉันจะบอกคุณว่าทำไมนั่นถึงจะเป็นแผนที่ดีที่สุด|lɛt͡ɕʰant͡ɕabɔːkkʰunawaːtʰaำmajnantʰɯŋat͡ɕapeːnpʰɛːnatʰiːdiːtʰiːsut
และฉันไม่รู้ว่าทำไม|lɛt͡ɕʰanmajruːwaːtʰaำmaj
และชุมชนบ้าง|lɛt͡ɕʰumt͡ɕʰanabaːŋ
และตอนนี้เขาก็สามารถดู|lɛtɔːnniːkʰeːaːka็saːmaːntʰaduː
และถึงจะไม่ได้มาวิเคราะห์อะไรมากมาย|lɛtʰɯŋt͡ɕamajdajmaːwikʰeːraːaʔarajmaːkmaːj
และพวกเราจะค้นพบตัวเราได้อย่างไรกัน|lɛpwokreːaːt͡ɕaknapʰobtuːa̯reːaːdajɔːjaːŋrajkan
และภารกิจนายก|lɛpʰaːnkit͡ɕanaːjok
และมองหาโดยทันที|lɛmɔːŋhaːdoːjtʰanatʰiː
และมิสเตอร์ริคาร์โดก็ติ๊กจุดที่สามของเขาออก|lɛmittɤːrikʰaːdoːka็tikt͡ɕudatʰiːsaːmkʰɔːŋakʰeːaːʔɔːk
และมีรอยสักรูปงูบนใบหน้า|lɛmiːrɔːjsakruːpŋuːbonbajhanaː
และยังทำในสิ่งที่เชื่อ|lɛjaŋtʰaำnajsiŋtʰiːt͡ɕʰɯːa̯
และยืนที่นั่นอย่างกล้าหาญ|lɛjɯːntʰiːnanɔːjaːŋklaːhaːj
และระวังปัญหาจากความหึงหวง|lɛrawaŋpajahaːt͡ɕaːkkʰwaːmhɯŋohwoŋ
และลองดูสิว่าพวกม้ามันยังเงียบแค่ไหน|lɛlɔːŋduːsiwaːpwakamaːmanjaŋaŋiːa̯bkʰɛːhajnaʔ
และอิสลามเป็นศาสนาอับบราฮัม|lɛʔitlaːmapeːnsaːsanaːʔabbaraːham
และอีกอย่างฉันบอกคุณกำลังจะมา|lɛʔiːkɔːjaːŋt͡ɕʰanabɔːkkʰunakaำlaŋt͡ɕamaː
และเธอชอบมิสซิสเจลลีบีได้ยังไงกันล่ะที่รัก|lɛtʰɤːt͡ɕʰɔːbmisasitt͡ɕeːlaliːbiːdajaŋŋajkanlatʰiːrak
และเรียก|lɛriːa̯k
และเวลากลางวันก็คลืบคลานมาอย่างรวดเร็ว|lɛweːlaːklaːŋawanka็kʰlɯːbkʰlaːnmaːɔːjaːŋrawotreːw
และโจยืนตัวสั่นและมองไปที่อาหารเช้าอย่างฉงน|lɛt͡ɕoːjɯːntuːa̯sanlɛmɔːŋpajtʰiːʔaːhaːnt͡ɕʰeːaːɔːjaːŋt͡ɕʰaŋon
และโอ้ฉันหวังว่าคุณจะได้เห็นเธอตามหลังนก|lɛʔoːt͡ɕʰanhawaŋwaːkʰunt͡ɕadajheːntʰɤːtaːmhalaŋnok
และในความรู้ที่เต็มไปอย่างมากมาย|lɛnajkʰwaːmruːtʰiːteːmpajɔːjaːŋmaːkamaːj
แล้วก็ดำเนินการไปตามขั้นตอน|lɛːwka็daำnɤnkaːrapajtaːmkʰanatɔːn
แล้วบทสนทนานี้ก็ค่อย|lɛːwbatʰotnatʰanaːniːka็kʰɔːj
แล้วเขาก็กลับมา|lɛːwkʰeːaːka็klabmaː
แล้วเขาก็ขึ้นไปขี่และปีนข้ามอีกครั้งบนเก้าอี้นวม|lɛːwkʰeːaːka็kʰɯnpajkʰiːlɛpiːnkʰaːmaʔiːkkʰraŋbanakeːaːʔiːnwom
แล้วเขาก็บอกเธอ|lɛːwkʰeːaːka็bɔːktʰɤː
แล้วเขาก็โน้มตัวลงไปที่หญิงสาวอีกครั้ง|lɛːwkʰeːaːka็noːmtuːa̯loŋpajtʰiːhjiŋasaːwʔiːkokraŋ
แสงอาทิตย์ส่องผ่านท้องฟ้าที่เต็มไปด้วยเมฆ|sɛːŋʔaːtʰitsɔːŋapʰaːntʰɔːŋafaːtʰiːteːmpajdowjameːk
แอนพูด|ʔɛːnpʰuːt
แอลกอฮอล์เช็ดแล้วก็จิ้มเข็ม|ʔɛːnkɔːhɔːt͡ɕʰeːtlɛːwaka็t͡ɕimkʰeːm
แฮตเตอร์ตอบกลับ|hɛːttɤːtɔːbklab
แฮรี่พูดด้วยความไม่สบอารมณ์นัก|hɛːriːpʰuːtdawojkʰwaːmmajsobʔaːromnak
โจรสลัดก็เรียกตามชื่อเครา|t͡ɕoːnsalatka็riːa̯ktaːmat͡ɕʰɯːɔːkʰeːraː
โดนกลาโหมเรียกตัวแล้ว|doːnklaːhoːmriːa̯katuːa̯lɛːw
โดยสิ่งที่คุณหมอจะซักถามทั้งคุณพ่อคุณแม่|doːjsiŋatʰiːkʰunhamɔːt͡ɕasaktʰaːmatʰaŋkʰunapʰɔːkʰunmɛː
โดยเฉพาะเวลาที่กินคู่กับขนมปังกรอบ|doːjt͡ɕʰeːpʰaːaweːlaːtʰiːkinkʰuːkabkʰanompaŋokrɔːb
โดยแยกจากจังหวัดนครพนม|doːjjɛːkat͡ɕaːkt͡ɕaŋohwadonkʰropnom
โดยแยกจากจังหวัดเชียงราย|doːjjɛːkat͡ɕaːkt͡ɕaŋohwadat͡ɕʰiːa̯ŋraːj
โต๊ะกาแฟสูงไปสำหรับที่นั่ง|tokaːfɛːsuːŋpajsaำharabtʰiːnaŋ
โทนี่ร้องออกมา|tʰoːniːrɔːŋʔɔːkamaː
โทรหาโจ|tʰoːnhaːt͡ɕoː
โทษที|tʰoːttʰiː
โพสต์ในเว็บกลุ่มเดียวกัน|pʰoːtnajweːbklumdiːa̯wakan
โฟมสีชมพูลอยผ่านอากาศอย่างนุ่มนวลและลอยลงสู่ยานพาหนะที่จอดอยู่|foːmsiːt͡ɕʰompʰuːlɔːjpʰaːnaʔaːkaːsɔːjaːŋnumonwalalɛlɔːjlaŋasuːjaːnpʰaːhanatʰiːt͡ɕɔːdɔːjuː
โรคระบาดโควิดสิบเก้าแสดงให้เห็นถึงอะไรหลายหลายอย่าง|roːkrabaːtkʰoːwitsibakeːaːsɛːtŋahajheːntʰɯŋaʔarajhalaːjhalaːjɔːjaːŋ
โอ้คุณจะทำอะไรเมื่อเขามาถึง|ʔoːkʰunt͡ɕatʰaำʔarajmɯːa̯kʰeːaːmaːtʰɯŋ
ใครกันที่จะเป็นอีกครั้ง|kʰajrakantʰiːt͡ɕapeːnʔiːkokraŋ
ใครคือกลินดา|kʰajrakʰɯːɔːklinadaː
ใครคือผู้บริหารองค์กรแห่งนี้|kʰajrakʰɯːɔːpʰuːbrihaːrɔːŋkrahɛːŋniː
ใครจะมาเข้าใจตัวเรา|kʰajrat͡ɕamaːkʰeːaːt͡ɕajtuːa̯reːaː
ใครเป็นผู้รับ|kʰajrapeːnpʰuːrab
ใครเป็นเจ้าของเครื่องเพชรพวกนี้กัน|kʰajrapeːnt͡ɕeːaːkʰɔːŋkʰeːrɯːɔːŋpʰeːt͡ɕʰonpʰawokniːkan
ใช่|t͡ɕʰaj
ใช่ค่ะ|t͡ɕʰajkʰaʔ
ใช่นั่นคือความจริงคือการตอบกลับ|t͡ɕʰajnankʰɯːɔːkwaːmotriŋakʰɯːɔːkaːntɔːboklab
ใช่มีความแตกต่างเขาพูด|t͡ɕʰajmiːkwaːmatɛːktaːŋakʰeːaːpʰuːt
ใช่อาหารชิ้นนั้น|t͡ɕʰajʔaːhaːnt͡ɕʰinanan
ใช่ไหม|t͡ɕʰajhajmaʔ
ในกรณีนั้น|najkonniːnan
ในขณะที่บางคนชื่นชมผู้พยากรณ์|najkʰanatʰiːbaːŋkʰanat͡ɕʰɯːnt͡ɕʰamapʰuːpjaːkon
ในขณะที่พวกเรากำลังรอ|najkʰanatʰiːpwokreːaːkaำlaŋrɔː
ในความเงียบงัน|najkʰwaːmŋiːa̯baŋan
ในน้ำมีปลาในนามีข้าว|najnaำmiːplaːnajnaːmiːkʰaːw
ในยุคสมัยใหม่แบบนี้|najjuksamajhajmabɛːbniː
ในส่วนหนึ่งของธุรกิจในเรื่องการดำเนินงาน|najsownahanɯŋkʰɔːŋatʰunkit͡ɕanajrɯːa̯ŋkaːradaำnɤnŋaːn
ในเวลาที่งานมันหายาก|najweːlaːtʰiːŋaːnmanahaːjaːk
ใฝ่ใจเอาใส่ห่อ|fajt͡ɕajʔeːaːsajhɔː
ให้กระดกโชว์กัน|hajkratkat͡ɕʰoːkan
ให้ช่วยโชว์ตัวเลขในแบงค์|hajt͡ɕʰowjat͡ɕʰoːtuːa̯leːknajbɛːŋ
ให้พวกเราพาตัวสมาชิกของเจ้าของบ้านไปทีละคน|hajpʰowkreːaːpʰaːtuːa̯tmaːt͡ɕʰikkʰɔːŋat͡ɕeːaːkʰɔːŋbaːnapajtʰiːlakʰon
ไก่ครึ่งโล|kajkʰrɯŋloː
ไข่ปีศาจรสชาติแย่มาก|kʰajpiːsaːtrasat͡ɕʰaːtijɛːmaːk
ได้ชัยชนะทางอุดมการณ์|dajt͡ɕʰajt͡ɕʰanatʰaːŋʔudomkaːn
ได้เมลแบบนี้บ่อยมาก|dajmeːnbɛːbaniːbɔːjmaːk
ได้แก่|dajkɛː
ได้โปรด|dajpoːrot
ไปข้างล่างแล้วขุดลงไป|pajkʰaːŋlaːŋalɛːwkʰudonŋapaj
ไพร่ฟ้าหน้าใส|pʰajrafaːhnaːsaj
ไม่|maj
ไม่งั้นมีความผิด|majŋanmiːkʰwaːmpʰit
ไม่ถามละ|majtʰaːmlaʔ
ไม่นานมานี้เอง|majnaːnmaːniːʔeːŋ
ไม่พักแล้วววว|majpʰaklɛːwowwow
ไม่มีความแตกต่างในเรื่องนี้ระหว่างโลหะฐานและของมีค่า|majmiːkwaːmatɛːktaːŋanajrɯːa̯ŋniːrahwaːŋaloːhatʰaːnlɛkʰɔːŋmiːkʰaː
ไม่มีทาง|majmiːtʰaːŋ
ไม่มีสำหรับมันอีกต่อไปแล้ว|majmiːsaำharabmanaʔiːktɔːpajlɛːw
ไม่มีอะไรทั้งนั้น|majmiːʔarajtʰaŋnan
ไม่มีอะไรที่จะช่วยมันได้|majmiːʔarajtʰiːt͡ɕatwajamandaj
ไม่มีเหล้าไปตั้งเป็นขวด|majmiːheːlaːpajtaŋpeːnokwot
ไม่มีใครรู้ว่ามัลคอมเป็นใคร|majmiːkʰajraruːwaːmankʰɔːmapeːnkʰajraʔ
ไม่รู้ว่าจะพาฉันไปไหน|majruːwaːt͡ɕapʰaːt͡ɕʰanpajhajnaʔ
ไม่ว่าอันไหนที่มันจะมีปัญหาก็ตาม|majwaːʔanhajnatʰiːmant͡ɕamiːpajhaːka็taːm
ไม่อยากก็ไม่ทำ|majɔːjaːkka็majtʰaำ
ไม่อ่ะ|majʔaʔ
ไม่เขาก็คุณยังคิดไม่ตกกับสิ่งที่อยู่ภายในจิตใจ|majkʰeːaːka็kʰunjaŋakʰitmajtokkabasiŋtʰiːɔːjuːpʰaːjnajt͡ɕitt͡ɕaj
ไม่เป็นไรฉันพูด|majpeːnrajt͡ɕʰanpʰuːt
ไม่เป็นไรหุ่นไล่กาพูด|majpeːnrajhunlajkaːpʰuːt
ไม่เร็วนัก|majreːwnak
ไม่ใช่การขู่คำราม|majt͡ɕʰajkaːnkʰuːkʰaำraːm
ไม่ใช่การพัฒนาและความเป็นธรรม|majt͡ɕʰajkaːnpʰatʰanaːlɛkwaːmapeːntʰrarom
ไม่ใช่ทางนี้|majt͡ɕʰajtʰaːŋniː
ไม่ใช่ปล่อยมาแบบนี้อะ|majt͡ɕʰajplɔːjmaːbɛːbniːʔaʔ
ไม่ใช่ไอซ์แลนด์|majt͡ɕʰajʔajlɛːn
ไม่ใช้ทรัพยากรสาธารณะกับเรื่องส่วนตัว|majt͡ɕʰajtʰrapjaːkonsaːtʰaːnnakabrɯːa̯ŋotwanatuːa̯
ไม่ได้ตั้งใจ|majdajtaŋt͡ɕaj
ไม้คือที่สุดในการทำของเล่นหรือบล็อค|majkʰɯːɔːtʰiːsutnajkaːntʰaำkʰɔːŋleːnohrɯːɔːbla็ɔːk
ไรงี้ใช่ป่ะ|rajŋiːt͡ɕʰajpaʔ
ไวน์ชั้นดีไม่ต้องการพุ่มไม้เฮรัลด์|wajt͡ɕʰandiːmajtɔːŋkaːrapʰummajheːran
ๆ|ๆ