'ayé|'ajé
000|000
1|1
29|29
30|30
a|a
aaroni|aaroni
abaddoni|abaddoni
abala|abala
abanijẹ́|abanid͡ʒɛ́
abarimu|abarimu
abdeeli|abdeeli
abdoni|abdoni
abednego|abedneɡo
abeli|abeli
abi|abi
abiatari|abiatari
abibu|abibu
abidani|abidani
abieli|abieli
abieseri|abieseri
abigaili|abiɡaili
abihaili|abihaili
abihu|abihu
abihudi|abihudi
abijah|abid͡ʒah
abilene|abilene
abimeleki|abimeleki
abinoamu|abĩoamu
abiramu|abiramu
abirùn|abirùn
abiṣagi|abiʃaɡi
abiṣai|abiʃai
abiṣua|abiʃua
abiṣuri|abiʃuri
abneri|abneri
aboyún|abojún
abrahamu|abrahamu
abramu|abramu
abrupt|abruk͡pt
absalomu|absalomu
aburú|aburú
abà|abà
abàmì|abàmì
abájọ|abád͡ʒɔ
abéégúnrín|abééɡúnrín
abìyẹ́|abìjɛ́
abíkẹ́|abíkɛ́
abínibí|abínibí
abírí|abírí
abíọ́dún|abíɔ́dún
abíọ́lá|abíɔ́lá
abíọ́nà|abíɔ́nà
abókùúsọ̀rọ̀|abókùúsɔ̀rɔ̀
abúlé|abúlé
abúra|abúra
abẹ|abɛ
abẹnu|abɛ̃u
abẹ̀mí|abɛ̀mí
abẹ́|abɛ́
abẹ́rẹ́|abɛ́rɛ́
abẹ́òkúta|abɛ́òkúta
abọ̀rìṣà|abɔ̀rìʃà
abọ́|abɔ́
adah|adah
adaiah|adaiah
adamawa|adamawa
adami|adami
adamu|adamu
adarí|adarí
addari|addari
addoni|addoni
adetìmí|adetìmí
adi|adi
adina|adĩa
adisa|adisa
adití|adití
admiralty|admiraltj
adoni|adoni
adonijah|adonid͡ʒah
adoniramu|adoniramu
adramittiu|adramittiu
adria|adria
adullamu|adullamu
adummimu|adummimu
adágún|adáɡún
adájọ́|adád͡ʒɔ́
adánilárayá|adánilárajá
adé|adé
adébámbọ̀|adébámbɔ̀
adébánjọ|adébánd͡ʒɔ
adébóyè|adébójè
adébọ̀wálé|adébɔ̀wálé
adédọlápọ̀|adédɔlák͡pɔ̀
adéfarasín|adéfarasín
adéforítì|adéforítì
adégẹyè|adéɡɛjè
adékúnlé|adékúnlé
adémìlúyìí|adémìlújìí
adémọ́lá|adémɔ́lá
adéníkẹ|adéníkɛ
adérónkẹ́|adérónkɛ́
adésuà|adésuà
adétiba|adétiba
adétutù|adétutù
adétọ́lá|adétɔ́lá
adéwálé|adéwálé
adéwùnmí|adéwùnmí
adéyanjú|adéjand͡ʒú
adéyinká|adéjĩká
adéyọ̀ọ́lá|adéjɔ̀ɔ́lá
adéyọọ́lá|adéjɔɔ́lá
adéògún|adéòɡún
adéṣẹwà|adéʃɛwà
adéẹ̀kọ́|adéɛ̀kɔ́
adéọlá|adéɔlá
adìyẹ|adìjɛ
adìẹ|adìɛ
adó|adó
adójútini|adód͡ʒútĩi
adùn|adùn
adúnmáradán|adúnmáradán
adúrú|adúrú
adẹdò|adɛdò
adẹ́tẹ̀|adɛ́tɛ̀
aenea|aenea
aenoni|aenoni
afeki|afeki
afeni|afeni
afiki|afiki
afiniṣòfò|afĩiʃòfò
afowópamọ́|afowók͡pamɔ́
afunfèrè|afũfèrè
afàyàfà|afàjàfà
afárá|afárá
afùnpè|afùnk͡pè
afúnrúgbìn|afúnrúɡ͡bìn
afẹ́fẹ́|afɛ́fɛ́
afọpẹ́fólúwa|afɔk͡pɛ́fólúwa
afọ̀rọ̀kẹ́lẹ́|afɔ̀rɔ̀kɛ́lɛ́
afọ́jú|afɔ́d͡ʒú
afọ́júìwọ|afɔ́d͡ʒúìwɔ
afọ́nilójú|afɔ́nilód͡ʒú
afọ́nnu|afɔ́nnu
agabu|aɡabu
agagi|aɡaɡi
agara|aɡara
agbani|aɡ͡bani
agbasọfọ̀|aɡ͡basɔfɔ̀
agbede|aɡ͡bede
agbejọ́rò|aɡ͡bed͡ʒɔ́rò
agbolé|aɡ͡bolé
agboolé|aɡ͡boolé
agbowó|aɡ͡bowó
agbábọ́ọ̀lù|aɡ͡bábɔ́ɔ̀lù
agbádá|aɡ͡bádá
agbálẹ̀|aɡ͡bálɛ̀
agbára|aɡ͡bára
agbárí|aɡ͡bárí
agbátẹrù|aɡ͡bátɛrù
agbègbè|aɡ͡bèɡ͡bè
agbèrò|aɡ͡bèrò
agbé|aɡ͡bé
agbéraga|aɡ͡béraɡa
agbófinró|aɡ͡bófĩró
agbóhùnsáfẹ́fẹ́|aɡ͡bóhùnsáfɛ́fɛ́
agbẹjẹ́rò|aɡ͡bɛd͡ʒɛ́rò
agbẹjọ́rò|aɡ͡bɛd͡ʒɔ́rò
agbẹnusọ|aɡ͡bɛ̃usɔ
agbẹ̀bí|aɡ͡bɛ̀bí
agbẹ̀san|aɡ͡bɛ̀san
agbọ̀n|aɡ͡bɔ̀n
agbọ́n|aɡ͡bɔ́n
agbọ́tí|aɡ͡bɔ́tí
aginjù|aɡĩd͡ʒù
aginjù’|aɡĩd͡ʒù’
ago|aɡo
agrippa|aɡrik͡pk͡pa
agége|aɡéɡe
agégi|aɡéɡi
agékúta|aɡékúta
agénifò|aɡénifò
agídí|aɡídí
agẹṣinjagun|aɡɛʃĩd͡ʒaɡũ
ahabu|ahabu
ahasbai|ahasbai
ahasi|ahasi
ahasiah|ahasiah
ahaswerusi|ahaswerusi
ahaṣi|ahaʃi
ahbani|ahbani
ahieseri|ahieseri
ahihudu|ahihudu
ahijah|ahid͡ʒah
ahikamu|ahikamu
ahiludi|ahiludi
ahimani|ahimani
ahimasi|ahimasi
ahimeleki|ahimeleki
ahinoamu|ahĩoamu
ahira|ahira
ahiramu|ahiramu
ahisamaki|ahisamaki
ahitofeli|ahitofeli
ahitubu|ahitubu
ahlabu|ahlabu
ahlai|ahlai
ahoro|ahoro
ahoro’|ahoro’
ahumai|ahumai
ahunṣọ|ahũʃɔ
ahussati|ahussati
ahéré|ahéré
ahọ́n|ahɔ́n
ai|ai
aiah|aiah
aijaloni|aid͡ʒaloni
aini|aĩi
ajigbèsè|ad͡ʒiɡ͡bèsè
ajigbèsè’|ad͡ʒiɡ͡bèsè’
ajogún|ad͡ʒoɡún
ajá|ad͡ʒá
ajábó|ad͡ʒábó
ajádìí|ad͡ʒádìí
ajáko|ad͡ʒáko
ajé|ad͡ʒé
ajétúnmọbí|ad͡ʒétúnmɔbí
ajíbádé|ad͡ʒíbádé
ajíbádẹ|ad͡ʒíbádɛ
ajíbóyè|ad͡ʒíbójè
ajíhìnrere|ad͡ʒíhìnrere
ajíjọlá|ad͡ʒíd͡ʒɔlá
ajírébi|ad͡ʒírébi
ajírọ́ba|ad͡ʒírɔ́ba
ajò|ad͡ʒò
ajónirun|ad͡ʒónirũ
ajẹran|ad͡ʒɛran
ajẹ́rìí|ad͡ʒɛ́rìí
akaia|akaia
akani|akani
akbori|akbori
akekèé|akekèé
akelausi|akelausi
akesẹ̀|akesɛ̀
akimu|akimu
akin|akĩ
akitiyan|akitijan
akiṣi|akiʃi
akko|akko
akokoro|akokoro
akori|akori
aksa|aksa
aksibu|aksibu
akuila|akuila
akànlé|akànlé
akálolo|akálolo
akáloló|akáloló
akéré|akéré
akérò|akérò
akésẹ̀|akésɛ̀
akéwì|akéwì
akéwọ́|akéwɔ́
akíkanjú|akíkand͡ʒú
akínbọ̀dé|akínbɔ̀dé
akínsanmí|akínsanmí
akínsọ̀yínù|akínsɔ̀jínù
akíntádé|akíntádé
akíntópé|akíntók͡pé
akíntóyè|akíntójè
akíntúndé|akíntúndé
akíntọ́lá|akíntɔ́lá
akíntọ́pẹ́|akíntɔ́k͡pɛ́
akínwándé|akínwándé
akínwùnmí|akínwùnmí
akókò|akókò
akókóró|akókóró
akónilẹ́rú|akónilɛ́rú
akóniṣiṣẹ́|akóniʃiʃɛ́
akẹgbé|akɛɡ͡bé
akẹgbẹ́|akɛɡ͡bɛ́
akẹ̀sán|akɛ̀sán
akẹ́kọ̀ọ́|akɛ́kɔ̀ɔ́
akọlà|akɔlà
akọni|akɔ̃i
akọrin|akɔrĩ
akọ̀wé|akɔ̀wé
akọ́lé|akɔ́lé
akọ́lédowó|akɔ́lédowó
alagbalúgbú|alaɡ͡balúɡ͡bú
alayé|alajé
alekisandiria|alekisandiria
aleksanderu|aleksanderu
alfa|alfa
alfeu|alfeu
algumu|alɡumu
alhaja|alhad͡ʒa
alhaji|alhad͡ʒi
alikama’|alikama’
alimon|alimon
alkedama|alkedama
allameleki|allameleki
allen|allen
almondi|almondi
alohùn|alohùn
aloti|aloti
aludùùrù|aludùùrù
aluṣi|aluʃi
alàgbà|alàɡ͡bà
alààyè|alààjè
alábojútó|alábod͡ʒútó
aláboyún|alábojún
alábà|alábà
alábàágbé|alábàáɡ͡bé
alábàápín|alábàák͡pín
alábágbé|alábáɡ͡bé
alábákú|alábákú
alábápín|alábák͡pín
alábáṣiṣẹ́|alábáʃiʃɛ́
alábáṣiṣẹ́pọ̀|alábáʃiʃɛ́k͡pɔ̀
alábòsí|alábòsí
alábòápàdé|alábòák͡pàdé
alábójútó|alábód͡ʒútó
alábùkún|alábùkún
aládé|aládé
aládùúgbò|aládùúɡ͡bò
aláfarawé|aláfarawé
aláfẹ́|aláfɛ́
aláfọ̀ṣẹ|aláfɔ̀ʃɛ
alága|aláɡa
alágbe|aláɡ͡be
alágbàfọ̀|aláɡ͡bàfɔ̀
alágbàro|aláɡ͡bàro
alágbàtọ́jú|aláɡ͡bàtɔ́d͡ʒú
alágbàwí|aláɡ͡bàwí
alágbàṣe|aláɡ͡bàʃe
alágbára|aláɡ͡bára
alágbèrè|aláɡ͡bèrè
alágbéká|aláɡ͡béká
alágbẹ̀dẹ|aláɡ͡bɛ̀dɛ
alágídí|aláɡídí
aláhesọ|aláhesɔ
alájà|alád͡ʒà
alájàpá|alád͡ʒàk͡pá
alájápá|alád͡ʒák͡pá
alájẹkì|alád͡ʒɛkì
alájẹṣu|alád͡ʒɛʃu
alájọni|alád͡ʒɔ̃i
alájọpín|alád͡ʒɔk͡pín
alájọru|alád͡ʒɔru
alákadá|alákadá
alákòóso|alákòóso
alákọbẹ̀rẹ̀|alákɔbɛ̀rɛ̀
alákọrí|alákɔrí
alákọ́kọ́|alákɔ́kɔ́
alálúpàyídà|alálúk͡pàjídà
alámì|alámì
alápatà|alák͡patà
alápáǹdẹ̀dẹ̀|alák͡páǹdɛ̀dɛ̀
alápòméjì|alák͡pòméd͡ʒì
alápẹẹrẹ|alák͡pɛɛrɛ
alára|alára
aláre|aláre
alárinà|alárĩà
aláriwo|aláriwo
aláràbarà|aláràbarà
aláràmbar|aláràmbar
aláràmbarà|aláràmbarà
alárékérekè|alárékérekè
alárékọjá|alárékɔd͡ʒá
alárìnkiri|alárìnkiri
aláròyé|aláròjé
aláró|aláró
alárẹrẹ|alárɛrɛ
alásè|alásè
alásẹ́wó|alásɛ́wó
alásọtẹ́lẹ̀|alásɔtɛ́lɛ̀
aláta|aláta
alátakò|alátakò
aláwòkọ́ṣe|aláwòkɔ́ʃe
aláwẹ́|aláwɛ́
aláwọ|aláwɔ
aláwọ̀|aláwɔ̀
aláwọ̀ṣe|aláwɔ̀ʃe
aláyídà|alájídà
aláyídáyidà|alájídájidà
aláàbò|aláàbò
aláàfin|aláàfĩ
aláàrùn|aláàrùn
aláàánú|aláàánú
aláàárù|aláàárù
aláàárẹ̀|aláàárɛ̀
aláìdúró|aláìdúró
aláìgbàgbọ́|aláìɡ͡bàɡ͡bɔ́
aláìgbé|aláìɡ͡bé
aláìgbédè|aláìɡ͡bédè
aláìgbọ́|aláìɡ͡bɔ́
aláìgbọ́n|aláìɡ͡bɔ́n
aláìgbọ́ràn|aláìɡ͡bɔ́ràn
aláìjẹ̀bi|aláìd͡ʒɛ̀bi
aláìjẹ́|aláìd͡ʒɛ́
aláìkẹ́kọ̀ọ́|aláìkɛ́kɔ̀ɔ́
aláìkọlà|aláìkɔlà
aláìlera|aláìlera
aláìlábàwọ́n|aláìlábàwɔ́n
aláìlábùkù|aláìlábùkù
aláìlágbára|aláìláɡ͡bára
aláìlákóṣo|aláìlákóʃo
aláìláàánú|aláìláàánú
aláìlè|aláìlè
aláìlèdáríjì|aláìlèdáríd͡ʒì
aláìlèdúró|aláìlèdúró
aláìlèfẹnusọ|aláìlèfɛ̃usɔ
aláìlérè|aláìlérè
aláìléso|aláìléso
aláìléwéko|aláìléwéko
aláìléèérí|aláìléèérí
aláìlófin|aláìlófĩ
aláìlópin|aláìlók͡pĩ
aláìlóye|aláìlóje
aláìlẹ́bi|aláìlɛ́bi
aláìlẹ́gbẹ́|aláìlɛ́ɡ͡bɛ́
aláìlẹ́gàn|aláìlɛ́ɡàn
aláìlẹ́kọ̀ọ́|aláìlɛ́kɔ̀ɔ́
aláìlẹ́mìí|aláìlɛ́mìí
aláìlẹ́ṣẹ̀|aláìlɛ́ʃɛ̀
aláìlọ́gbọ́n|aláìlɔ́ɡ͡bɔ́n
aláìlọ́mọ|aláìlɔ́mɔ
aláìlọ́pẹ́|aláìlɔ́k͡pɛ́
aláìmoore|aláìmoore
aláìmu|aláìmu
aláìmòye|aláìmòje
aláìmọ|aláìmɔ
aláìmọ̀kan|aláìmɔ̀kan
aláìmọ́|aláìmɔ́
aláìnání|aláìnání
aláìní|aláìní
aláìnífẹ̀ẹ́|aláìnífɛ̀ɛ́
aláìnígbàgbọ́|aláìníɡ͡bàɡ͡bɔ́
aláìníláárí|aláìníláárí
aláìnílò|aláìnílò
aláìro|aláìro
aláìrékọjá|aláìrékɔd͡ʒá
aláìríran|aláìríran
aláìríwí|aláìríwí
aláìríṣẹ́|aláìríʃɛ́
aláìsàn|aláìsàn
aláìsìn|aláìsìn
aláìsọ|aláìsɔ
aláìtó|aláìtó
aláìtún|aláìtún
aláìtọ́jú|aláìtɔ́d͡ʒú
aláìwà|aláìwà
aláìwú|aláìwú
aláìwọṣọ|aláìwɔʃɔ
aláìyẹ|aláìjɛ
aláìṣòdodo|aláìʃòdodo
aláìṣòótọ́|aláìʃòótɔ́
aláìṣẹ̀|aláìʃɛ̀
aláǹgbá|aláǹɡ͡bá
aláǹtakùn|aláǹtakùn
aláṣehàn|aláʃehàn
aláṣepé|aláʃek͡pé
aláṣẹ|aláʃɛ
aláṣọ|aláʃɔ
alòbá|alòbá
alóhun|alóhũ
alóńgẹ|alóńɡɛ
alẹ́|alɛ́
alọ́ba|alɔ́ba
alọ́nilọ́wọ́gbà|alɔ́nilɔ́wɔ́ɡ͡bà
amadi|amadi
amagedoni|amaɡedoni
amaleki|amaleki
amariah|amariah
amasa|amasa
amasai|amasai
amasiah|amasiah
amittai|amittai
ammieli|ammieli
ammihudu|ammihudu
amminadabu|ammĩadabu
ammiṣaddai|ammiʃaddai
ammoni|ammoni
amnoni|amnoni
amojútó|amod͡ʒútó
amoni|amoni
amori|amori
amosi|amosi
ampliatu|amk͡pliatu
amramu|amramu
amáyédẹrùn|amájédɛrùn
amáyédẹ̀rún|amájédɛ̀rún
amòfin|amòfĩ
amòye|amòje
amóhùnmáwòrán|amóhùnmáwòrán
amóríbọ́|amóríbɔ́
amósùn|amósùn
amúdá|amúdá
amúlétutu|amúlétutu
amúlétutù|amúlétutù
amúlẹ̀tutu|amúlɛ̀tutu
amúnisìn|amúnisìn
amúnkùn|amúnkùn
amúnáwá|amúnáwá
amẹ́ríkà|amɛ́ríkà
amọ̀|amɔ̀
amọ̀kòkò|amɔ̀kòkò
amọ̀nà|amɔ̀nà
an|an
anaki|anaki
anania|anania
ananiah|ananiah
anatoti|anatoti
anderu|anderu
androniku|androniku
anenu|anenu
aneri|aneri
angẹli|anɡɛli
aninilára|anĩilára
anna|anna
annasi|annasi
anoti|anoti
antioku|antioku
antipa|antik͡pa
antipatrisi|antik͡patrisi
anímáṣahun|anímáʃahũ
aníní|aníní
apani|ak͡pani
apanijẹ|ak͡panid͡ʒɛ
apanirun|ak͡panirũ
apelle|ak͡pelle
apidán|ak͡pidán
apii|ak͡pii
apollioni|ak͡pollioni
apollo|ak͡pollo
apollo”|ak͡pollo”
aporo|ak͡poro
aposteli|ak͡posteli
appaimu|ak͡pk͡paimu
apànìyàn|ak͡pànìjàn
apá|ak͡pá
apárí|ak͡párí
apèèrè|ak͡pèèrè
apògèdè|ak͡pòɡèdè
apó|ak͡pó
apẹyẹ|ak͡pɛjɛ
apẹ̀gàn|ak͡pɛ̀ɡàn
apẹ̀rẹ̀|ak͡pɛ̀rɛ̀
apọ́ngbọ̀n|ak͡pɔ́nɡ͡bɔ̀n
apọ́nilójú|ak͡pɔ́nilód͡ʒú
ara|ara
araba|araba
arabah|arabah
arabia|arabia
aradi|aradi
aramaiki|aramaiki
aramu|aramu
ararati|ararati
ardi|ardi
areopagu|areok͡paɡu
areta|areta
arfadi|arfadi
arfaksadi|arfaksadi
arfakṣadi|arfakʃadi
argobu|arɡobu
ari|ari
arie|arie
arieli|arieli
arimatea|arimatea
arioku|arioku
aristarku|aristarku
aristobulu|aristobulu
ariwo|ariwo
arki|arki
arkippu|arkik͡pk͡pu
arnoni|arnoni
aroeri|aroeri
arpadi|ark͡padi
arsa|arsa
artema|artema
artemisi|artemisi
aràn|aràn
aràwọn|aràwɔ̃
ará|ará
arábìnrin|arábìnrĩ
arákùnrin|arákùnrĩ
aránṣọ|aránʃɔ
aráyé|arájé
aré|aré
arìnrìn|arìnrìn
aríran|aríran
aríìkẹ́|aríìkɛ́
aríṣekọ́lá|aríʃekɔ́lá
arò|arò
aró|aró
arógunyò|aróɡũjò
arógunyọ̀|aróɡũjɔ̀
arómáṣọdún|arómáʃɔdún
arúfin|arúfĩ
arúfin’|arúfĩ’
arúgbó|arúɡ͡bó
arẹwà|arɛwà
arẹ́gbẹ́ṣọlá|arɛ́ɡ͡bɛ́ʃɔlá
arọ|arɔ
asa|asa
asafu|asafu
asaheli|asaheli
asareeli|asareeli
asariah|asariah
aseka|aseka
asenati|asenati
asifati|asifati
asinkritu|asĩkritu
asiria|asiria
asori|asori
asosi|asosi
asotu|asotu
asrieli|asrieli
assani|assani
assari|assari
asuba|asuba
asà|asà
asán|asán
asé|asé
asìnkú|asìnkú
asṣuri|asʃuri
asọnidahoro|asɔ̃idahoro
asọ̀|asɔ̀
asọ̀rọ̀|asɔ̀rɔ̀
atadi|atadi
atalia|atalia
ataliah|ataliah
atarotu|atarotu
ata’re|ata’re
ateni|ateni
atikú|atikú
attai|attai
atukọ̀|atukɔ̀
atá|atá
atẹ̀wé|atɛ̀wé
atẹ́|atɛ́
atẹ́gùn|atɛ́ɡùn
atẹ́rere|atɛ́rere
atọjúlékiri|atɔd͡ʒúlékiri
atọ̀húnrìnwá|atɔ̀húnrìnwá
atọ̀ọ́lé|atɔ̀ɔ́lé
atọ́batẹ́lẹ̀|atɔ́batɛ́lɛ̀
atọ́kóṣẹ̀|atɔ́kóʃɛ̀
atọ́kùn|atɔ́kùn
atọ́kọ̀sẹ|atɔ́kɔ̀sɛ
atọ́kọ̀ṣe|atɔ́kɔ̀ʃe
atọ́nisọ́nà|atɔ́nisɔ́nà
atọ́nà|atɔ́nà
augustu|auɡustu
avenue|avenue
awakọ̀|awakɔ̀
awalẹ̀|awalɛ̀
awòràwọ̀|awòràwɔ̀
awólọ́wọ̀|awólɔ́wɔ̀
awọ|awɔ
ayahi|ajahi
ayálégbé|ajáléɡ͡bé
ayánilówó|ajánilówó
ayára|ajára
ayárabíàṣá|ajárabíàʃá
ayé|ajé
ayéfẹ́lẹ́|ajéfɛ́lɛ́
ayélujára|ajélud͡ʒára
ayélàágbé|ajélàáɡ͡bé
ayérayé|ajérajé
ayé’|ajé’
ayò|ajò
ayùn|ajùn
ayẹyẹ|ajɛjɛ
ayọ̀|ajɔ̀
ayọ̀bámi|ajɔ̀bámi
ayọ̀dèjì|ajɔ̀dèd͡ʒì
ayọ̀mídé|ajɔ̀mídé
ayọ́kẹ́lẹ́|ajɔ́kɛ́lɛ́
ayọ́lẹ̀wò|ajɔ́lɛ̀wò
aà|aà
aáwọ̀|aáwɔ̀
aáyán|aáján
ańgẹ́lì|ańɡɛ́lì
aṣani|aʃani
aṣbeli|aʃbeli
aṣdodu|aʃdodu
aṣebi|aʃebi
aṣerah|aʃerah
aṣeri|aʃeri
aṣibea|aʃibea
aṣiwèrè|aʃiwèrè
aṣkeloni|aʃkeloni
aṣkenasi|aʃkenasi
aṣojú|aʃod͡ʒú
aṣtarotu|aʃtarotu
aṣtoreti|aʃtoreti
aṣàtìpó|aʃàtìk͡pó
aṣàìgbọràn|aʃàìɡ͡bɔràn
aṣá|aʃá
aṣáko|aʃáko
aṣálẹ̀|aʃálɛ̀
aṣáájú|aʃáád͡ʒú
aṣèbàjẹ́|aʃèbàd͡ʒɛ́
aṣèyíówùú|aʃèjíówùú
aṣíwájú|aʃíwád͡ʒú
aṣòdì|aʃòdì
aṣòfin|aʃòfĩ
aṣẹ́gun|aʃɛ́ɡũ
aṣọ̀fọ̀|aʃɔ̀fɔ̀
aṣọ́bodè|aʃɔ́bodè
aṣọ́nà|aʃɔ́nà
a”|a”
ba|ba
baalati|baalati
baali|baali
baalimu|baalimu
baali’|baali’
baana|baana
baanah|baanah
baaṣa|baaʃa
baba|baba
babaláwo|babaláwo
baba’|baba’
babeli|babeli
babeli’|babeli’
babiloni|babiloni
babà|babà
babájídé|babád͡ʒídé
babátúńdé|babátúńdé
balaamu|balaamu
balaki|balaki
balógun|balóɡũ
balùwẹ̀|balùwɛ̀
balẹ̀|balɛ̀
bamitiisi|bamitiisi
bamitiisi’|bamitiisi’
bamoti|bamoti
bani|bani
banújẹ́|banúd͡ʒɛ́
bar|bar
baraba|baraba
barakeli|barakeli
baraki|baraki
bariga|bariɡa
barle|barle
barnaba|barnaba
barnea|barnea
barsaba|barsaba
barsillai|barsillai
bartimeu|bartimeu
bartolomeu|bartolomeu
baruku|baruku
basemati|basemati
basi|basi
bati|bati
batṣeba|batʃeba
batẹnijẹ́|batɛ̃id͡ʒɛ́
bauchi|bauchi
baà|baà
baálé|baálé
baálẹ̀|baálɛ̀
baṣani|baʃani
baṣọ̀run|baʃɔ̀rũ
beari|beari
beelsebulu|beelsebulu
beeri|beeri
beeroti|beeroti
beerṣeba|beerʃeba
bekeri|bekeri
bela|bela
beliali|beliali
belṣassari|belʃassari
benaiah|benaiah
bene|bene
beni|beni
benjamini|bend͡ʒamĩi
beori|beori
berea|berea
beredi|beredi
berekiah|berekiah
beriah|beriah
beriti|beriti
bernike|bernike
berota|berota
besaleli|besaleli
beseki|beseki
beseri|beseri
besodeiah|besodeiah
betani|betani
beteli|beteli
betfage|betfaɡe
beti|beti
betisaida|betisaida
betueli|betueli
bigitana|biɡitana
bikri|bikri
bilasitu|bilasitu
bileamu|bileamu
bilidadi|bilidadi
biliha|biliha
bimhali|bimhali
binnui|bĩnui
biri|biri
biribiri|biribiri
bitinia|bitĩia
bo|bo
boanaji|boanad͡ʒi
boasi|boasi
bodè|bodè
bohani|bohani
bojú|bod͡ʒú
bojútó|bod͡ʒútó
bokimu|bokimu
bolẹ̀|bolɛ̀
bomirin|bomirĩ
bora|bora
bori|bori
borí|borí
bosra|bosra
breath|breath
bu|bu
buhari|buhari
bukki|bukki
bulu|bulu
bunni|bũni
burú|burú
burúkú|burúkú
busi|busi
busii|busii
buyì|bujì
bà|bà
bàba|bàba
bàbà|bàbà
bàbàrà|bàbàrà
bàbá|bàbá
bàbáa|bàbáa
bàbángídá|bàbánɡídá
bàjẹ́|bàd͡ʒɛ́
bàlágà|bàláɡà
bàrúwá|bàrúwá
bàtà|bàtà
bàtàa|bàtàa
bàá|bàá
bàìbàì|bàìbàì
bá|bá
báa|báa
bádé|bádé
bákan|bákan
bámi|bámi
bámú|bámú
báni|báni
bánkẹ́|bánkɛ́
bára|bára
báwa|báwa
báwo|báwo
báwọ̀nyí|báwɔ̀njí
báyi|báji
báyì|bájì
báyìí|bájìí
báyìíì|bájìíì
báyọ̀|bájɔ̀
báàgì|báàɡì
báálẹ̀|báálɛ̀
báǹkì|báǹkì
bá̀|bá̀
bá’ni|bá’ni
bèbè|bèbè
bèbí|bèbí
bèèrè|bèèrè
bélò|bélò
béèrè|béèrè
bì|bì
bìkítà|bìkítà
bí|bí
bíba|bíba
bíbu|bíbu
bíbá|bíbá
bíbí|bíbí
bíbíire|bíbíire
bíbísí|bíbísí
bíbùkún|bíbùkún
bíbú|bíbú
bíbọ|bíbɔ
bíbọ̀|bíbɔ̀
bíbọ́|bíbɔ́
bídèmí|bídèmí
bíi|bíi
bíléèdì|bíléèdì
bímpé|bímk͡pé
bímọ|bímɔ
bínú|bínú
bíríkì|bíríkì
bíríkìlà|bíríkìlà
bísí|bísí
bísólì|bísólì
bísóyè|bísójè
bíyi|bíji
bíìmù|bíìmù
bíṣọ́ọ̀bù|bíʃɔ́ɔ̀bù
bíọ́dún|bíɔ́dún
bí’|bí’
bí’mọ|bí’mɔ
bí’nú|bí’nú
bò|bò
bòòji|bòòd͡ʒi
bòó|bòó
bó|bó
bójú|bód͡ʒú
bójúmu|bód͡ʒúmu
bóo|bóo
bótobòto|bótobòto
bótò|bótò
bótó|bótó
bóyá|bójá
bóòlù|bóòlù
bù|bù
bùba|bùba
bùgan|bùɡan
bùjẹbùdànù|bùd͡ʒɛbùdànù
bùkátà|bùkátà
bùkún|bùkún
bùkọ́lá|bùkɔ́lá
bú|bú
bú'jọba|bú'd͡ʒɔba
búburú|búburú
búburú’|búburú’
búgan|búɡan
búra|búra
búrẹ́dì|búrɛ́dì
bẹ|bɛ
bẹtilẹhẹmu|bɛtilɛhɛmu
bẹ̀|bɛ̀
bẹ̀bẹ̀|bɛ̀bɛ̀
bẹ̀rè|bɛ̀rè
bẹ̀rù|bɛ̀rù
bẹ̀rẹ̀|bɛ̀rɛ̀
bẹ̀wò|bɛ̀wò
bẹ́|bɛ́
bẹ́ẹ̀|bɛ́ɛ̀
bọ|bɔ
bọwọ́|bɔwɔ́
bọ̀|bɔ̀
bọ̀dá|bɔ̀dá
bọ̀dé|bɔ̀dé
bọ̀gìnì|bɔ̀ɡìnì
bọ̀lì|bɔ̀lì
bọ̀rìṣà|bɔ̀rìʃà
bọ̀wọ̀|bɔ̀wɔ̀
bọ̀ọ́|bɔ̀ɔ́
bọ̀’|bɔ̀’
bọ́|bɔ́
bọ́lá|bɔ́lá
bọ́láfadé|bɔ́láfadé
bọ́ọ̀lù|bɔ́ɔ̀lù
bọ́ọ́lù|bɔ́ɔ́lù
bọ́’lè|bɔ́’lè
b’ódún|b’ódún
b’ólóde|b’ólóde
b’ẹkùn|b’ɛkùn
b’ẹ́kùn|b’ɛ́kùn
b’ọ̀gún|b’ɔ̀ɡún
caleb|caleb
califonia|califonia
ceter|ceter
chelsea|chelsea
civic|civic
d'áyé|d'ájé
da|da
daa|daa
dabbeṣeti|dabbeʃeti
dabe|dabe
daberati|daberati
dadakùádà|dadakùádà
dafidi|dafidi
dagoni|daɡoni
dahoro|dahoro
dalmanuta|dalmanuta
dalóhùn|dalóhùn
dalẹ̀|dalɛ̀
damari|damari
damasku|damasku
dan|dan
dandan|dandan
dani|dani
daniẹli|daniɛli
danù|danù
dara|dara
darandaran|darandaran
darapọ̀|darak͡pɔ̀
dariusi|dariusi
darí|darí
darúgbó|darúɡ͡bó
dasán|dasán
datani|datani
daá|daá
daṣọ|daʃɔ
da’ṣé|da’ʃé
de|de
debari|debari
debiri|debiri
dedani|dedani
dekapoli|dekak͡poli
delaiah|delaiah
dema|dema
demetriusi|demetriusi
deueli|deueli
diblataimu|diblataimu
diboni|diboni
didimu|didimu
digbí|diɡ͡bí
dili|dili
dimina|dimĩa
din|dĩ
dina|dĩa
dionisiu|dionisiu
diotirefe|diotirefe
dira|dira
dití|dití
diṣani|diʃani
diṣoni|diʃoni
dodafahu|dodafahu
doegi|doeɡi
dojú|dod͡ʒú
dojúbo|dod͡ʒúbo
dojúbolẹ̀|dod͡ʒúbolɛ̀
dojúkọ|dod͡ʒúkɔ
dolówó|dolówó
dolóògbé|dolóòɡ͡bé
dori|dori
dorí|dorí
doyin|dojĩ
dragoni|draɡoni
drusilla|drusilla
dun|dũ
dunjúdunjú|dũd͡ʒúdũd͡ʒú
dunnú|dũnú
dà|dà
dàbí|dàbí
dàda|dàda
dàdàkùádà|dàdàkùádà
dàgbà|dàɡ͡bà
dàgbàsókè|dàɡ͡bàsókè
dàmú|dàmú
dànù|dànù
dàpọ̀|dàk͡pɔ̀
dàrú|dàrú
dààmú|dààmú
dàànù|dàànù
dàánù|dàánù
dàásíkí|dàásíkí
dá|dá
dáa|dáa
dáadáa|dáadáa
dábàá|dábàá
dábùú|dábùú
dádé|dádé
dádúró|dádúró
dáfídì|dáfídì
dágbé|dáɡ͡bé
dágbére|dáɡ͡bére
dágunró|dáɡũró
dáhùn|dáhùn
dájú|dád͡ʒú
dájúdájú|dád͡ʒúdád͡ʒú
dájú’|dád͡ʒú’
dájọ́|dád͡ʒɔ́
dákú|dákú
dákẹ́|dákɛ́
dálé|dálé
dámilọ́lá|dámilɔ́lá
dámọ̀ràn|dámɔ̀ràn
dán|dán
dánilójú|dánilód͡ʒú
dánilẹ́kun|dánilɛ́kũ
dánwò|dánwò
dáná|dáná
dání|dání
dáníẹ̀lì|dáníɛ̀lì
dára|dára
dáradára|dáradára
dárayá|dárajá
dáre|dáre
dárí|dárí
dáríji|dáríd͡ʒi
dáríjì|dáríd͡ʒì
dárò|dárò
dárúkọ|dárúkɔ
dátọ́mì|dátɔ́mì
dáwó|dáwó
dáwọ́|dáwɔ́
dáwọ́jọ|dáwɔ́d͡ʒɔ
dáwọ́lé|dáwɔ́lé
dáyà|dájà
dáyé́|dájé́
dáàbò|dáàbò
dáṣà|dáʃà
dáṣẹ́|dáʃɛ́
dá’wọ́|dá’wɔ́
dè|dè
dèjì|dèd͡ʒì
dènà|dènà
dèé|dèé
dé|dé
débi|débi
dédé|dédé
dée|dée
délé|délé
délẹ̀|délɛ̀
démiládé|démiládé
démiláre|démiláre
dénà|dénà
dénú|dénú
désọ́lá|désɔ́lá
déédé|déédé
dé’|dé’
dé’lu|dé’lu
dé’lùú|dé’lùú
dé’lẹ̀|dé’lɛ̀
dì|dì
dìbò|dìbò
dìde|dìde
dìde’|dìde’
dìpọ̀|dìk͡pɔ̀
dìrọ̀|dìrɔ̀
dìtẹ̀|dìtɛ̀
dìwọ́n|dìwɔ́n
dìímú|dìímú
dí|dí
díbàjẹ́|díbàd͡ʒɛ́
dída|dída
dídi|dídi
dídàbolẹ̀|dídàbolɛ̀
dídá|dídá
dídán|dídán
dídápadà|dídák͡padà
dídára|dídára
dídè|dídè
dídé|dídé
dídì|dídì
dídí|dídí
dídùn|dídùn
dídùndídùn|dídùndídùn
dídúró|dídúró
dídẹ̀|dídɛ̀
dígí|díɡí
díje|díd͡ʒe
dín|dín
díndín|díndín
dínkù|dínkù
dínárì|dínárì
dípò|dík͡pò
díwọ̀|díwɔ̀
díwọ̀n|díwɔ̀n
díye|díje
díyàjẹ|díjàd͡ʒɛ
díákónì|díákónì
díẹ̀|díɛ̀
díẹ̀díẹ̀|díɛ̀díɛ̀
dò|dò
dòdò|dòdò
dògbó|dòɡ͡bó
dòjé|dòd͡ʒé
dòmìnira|dòmìnira
dòwe|dòwe
dòwò|dòwò
dó|dó
dógò|dóɡò
dójúti|dód͡ʒúti
dójútì|dód͡ʒútì
dóko|dóko
dókìtà|dókìtà
dókítà|dókítà
dópin|dók͡pĩ
dórí|dórí
dóró|dóró
dówe|dówe
dù|dù
dùbúlẹ̀|dùbúlɛ̀
dùn|dùn
dùn'yan|dùn'jan
dùrù|dùrù
dùyan|dùjan
dùùrù|dùùrù
dúdú|dúdú
dúkìá|dúkìá
dún|dún
dúndùn|dúndùn
dúpé|dúk͡pé
dúpẹ́|dúk͡pɛ́
dúró|dúró
dúrúu|dúrúu
dúńbú|dúńbú
dẹ|dɛ
dẹkùn|dɛkùn
dẹlila|dɛlila
dẹni|dɛ̃i
dẹnukọlẹ̀|dɛ̃ukɔlɛ̀
dẹrùn|dɛrùn
dẹtí|dɛtí
dẹ̀|dɛ̀
dẹ̀dẹ̀|dɛ̀dɛ̀
dẹ̀dẹ̀’|dɛ̀dɛ̀’
dẹ̀gbẹ́|dɛ̀ɡ͡bɛ́
dẹ́kun|dɛ́kũ
dẹ́kùn|dɛ́kùn
dẹ́kún|dɛ́kún
dẹ́nu|dɛ́nu
dẹ́rù|dɛ́rù
dẹ́rùbà|dɛ́rùbà
dẹ́sẹ̀|dɛ́sɛ̀
dẹ́ṣẹ̀|dɛ́ʃɛ̀
dẹẹ́|dɛɛ́
dọdẹ|dɔdɛ
dọkasi|dɔkasi
dọlọ́rọ̀|dɔlɔ́rɔ̀
dọ̀bálẹ̀|dɔ̀bálɛ̀
dọ̀kan|dɔ̀kan
dọ̀tí|dɔ̀tí
dọ́gba|dɔ́ɡ͡ba
dọ́kítà|dɔ́kítà
d’ahoro|d’ahoro
d’ilé|d’ilé
d’àgbà|d’àɡ͡bà
d’ádé|d’ádé
d’órí|d’órí
d’ẹ́se|d’ɛ́se
d’ẹ́sẹ̀|d’ɛ́sɛ̀
d’ọjà|d’ɔd͡ʒà
e|e
ebali|ebali
ebedi|ebedi
ebedimeleki|ebedimeleki
ebeneseri|ebeneseri
eberi|eberi
ebi|ebi
eboni|eboni
ebè|ebè
ebí|ebí
ebòlò|ebòlò
edeni|edeni
ederi|ederi
edomu|edomu
edrei|edrei
edé|edé
eegun|eeɡũ
eegún|eeɡún
efa|efa
efai|efai
efangelisti|efanɡelisti
efani|efani
efata|efata
eferi|eferi
efesu|efesu
efi|efi
efili|efili
efodu|efodu
efraimu|efraimu
efrata|efrata
efroni|efroni
egbére|eɡ͡bére
egbò|eɡ͡bò
egbòogi|eɡ͡bòoɡi
egla|eɡla
eglati|eɡlati
egloni|eɡloni
egúngún|eɡúnɡún
ehudu|ehudu
ejibiti|ed͡ʒibiti
ejibiti’|ed͡ʒibiti’
ejò|ed͡ʒò
ekbatana|ekbatana
ekedi|ekedi
ekroni|ekroni
eksodu|eksodu
eku|eku
ekuru|ekuru
el|el
ela|ela
elamu|elamu
elati|elati
eldadi|eldadi
eleale|eleale
eleasa|eleasa
eleasari|eleasari
elhanani|elhanani
eli|eli
eliabu|eliabu
eliakimu|eliakimu
eliamu|eliamu
eliasafu|eliasafu
eliaṣibu|eliaʃibu
elieli|elieli
elieseri|elieseri
elifasi|elifasi
elifeleti|elifeleti
elihu|elihu
elihudi|elihudi
elijah|elid͡ʒah
elika|elika
elimeleki|elimeleki
elimu|elimu
elisabeti|elisabeti
elisafani|elisafani
elisafati|elisafati
elisuri|elisuri
eliṣa|eliʃa
eliṣama|eliʃama
eliṣeba|eliʃeba
elkana|elkana
elmadamu|elmadamu
elnatani|elnatani
eloni|eloni
elsafani|elsafani
elteke|elteke
eltekoni|eltekoni
elédùmarè|elédùmarè
elégbè|eléɡ͡bè
elékòó|elékòó
elépo|elék͡po
elére|elére
elése|elése
eléso|eléso
elétè|elétè
elétí|elétí
elétò|elétò
eléwé|eléwé
eléwú|eléwú
eléyi|eléji
eléyìí|eléjìí
eléèérí|eléèérí
elódùmarè|elódùmarè
elújọbí|elúd͡ʒɔbí
emeki|emeki
emeradi|emeradi
emimu|emimu
emmanueli|emmanueli
emmausi|emmausi
en|en
enaimu|enaimu
enani|enani
enanu|enanu
eni|eni
enoku|enoku
enosi|enosi
enoṣi|enoʃi
enìkan|enìkan
enìkankan|enìkankan
ení|ení
enígbà|eníɡ͡bà
epafira|ek͡pafira
epafiroditu|ek͡pafiroditu
epenetu|ek͡penetu
epikure|ek͡pikure
erani|erani
erastu|erastu
eri|eri
erinmí|erĩmí
eruku|eruku
eré|eré
erékùṣù|erékùʃù
erékúṣù|erékúʃù
erín|erín
erùpẹ̀|erùk͡pɛ̀
esarhadoni|esarhadoni
esau|esau
esekiẹli|esekiɛli
eseri|eseri
esili|esili
esioni|esioni
esra|esra
esteri|esteri
etamu|etamu
etani|etani
eteri|eteri
eti|eti
etiopia|etiok͡pia
etu|etu
etí|etí
etígbọ̀ọ́|etíɡ͡bɔ̀ɔ́
etílé|etílé
eubulu|eubulu
eufurate|eufurate
euodia|euodia
eurakuilo|eurakuilo
eutiku|eutiku
ewé|ewé
ewébẹ̀|ewébɛ̀
ewédú|ewédú
ewéko|ewéko
ewì|ewì
ewúro|ewúro
ewúré|ewúré
ewúrẹ́|ewúrɛ́
external|external
eyín|ejín
eyín’|ejín’
eèrà|eèrà
eégún|eéɡún
eékún|eékún
eérú|eérú
eéwo|eéwo
eṣinṣín|eʃĩʃín
eṣitemoa|eʃitemoa
eṣkolu|eʃkolu
eṣtaoli|eʃtaoli
eṣú|eʃú
eẹ̀yan|eɛ̀jan
f'ólúwa|f'ólúwa
fa|fa
fadérẹra|fadérɛra
fajúro|fad͡ʒúro
fakọ́yọ|fakɔ́jɔ
falẹ̀|falɛ̀
falẹ̀’|falɛ̀’
fanimọ́ra|fanimɔ́ra
faniya|fanija
fara|fara
farabalẹ̀|farabalɛ̀
faradà|faradà
farahan|farahan
farahàn|farahàn
faransé|faransé
farao|farao
farisi|farisi
fayé|fajé
faṣti|faʃti
febe|febe
feliksi|feliksi
festu|festu
fetí|fetí
fetísí|fetísí
fetísílẹ̀|fetísílɛ̀
figbe|fiɡ͡be
fihan|fihan
fihàn|fihàn
fikoli|fikoli
filadelfia|filadelfia
filakteri|filakteri
filetu|filetu
filipi|filik͡pi
filistia|filistia
filistini|filistĩi
filologu|filoloɡu
finehasi|fĩehasi
firi|firi
fitafita|fitafita
fiwé|fiwé
fiyèsí|fijèsí
flegoni|fleɡoni
fo|fo
fohùn|fohùn
fojú|fod͡ʒú
fojúsọ́nà|fod͡ʒúsɔ́nà
folúkẹ́|folúkɛ́
fonike|fonike
fonisia|fonisia
fonọ́lọ́jì|fonɔ́lɔ́d͡ʒì
foroni|foroni
forí|forí
foríbalẹ̀|foríbalɛ̀
forítì|forítì
frigia|friɡia
fun|fũ
funfun|fũfũ
funra|fũra
fuń|fṹ
fà|fà
fàdákà|fàdákà
fàkẹrẹ|fàkɛrɛ
fàlí|fàlí
fàmọ́|fàmɔ́
fàro|fàro
fàsẹ́yìn|fàsɛ́jìn
fàtu|fàtu
fàya|fàja
fàyàrán|fàjàrán
fàyè|fàjè
fàyọ|fàjɔ
fàájì|fàád͡ʒì
fá|fá
fágúnwà|fáɡúnwà
fájídé|fád͡ʒídé
fákáyọ̀dé|fákájɔ̀dé
fálànà|fálànà
fálétí|fálétí
fárí|fárí
fásitì|fásitì
fásúre|fásúre
fátùrótì|fátùrótì
fátúrótì|fátúrótì
fáuśa|fáuśa
fáànù|fáànù
fáìlì|fáìlì
fáṣọpẹ́|fáʃɔk͡pɛ́
fèdèfọ̀|fèdèfɔ̀
fèrè|fèrè
fèrèsé|fèrèsé
fèsì|fèsì
fèyíkọ́gbọ́n|fèjíkɔ́ɡ͡bɔ́n
fé|fé
féfé|féfé
féraǹ|féraǹ
férémù|férémù
fì|fì
fìdí|fìdí
fìgbà|fìɡ͡bà
fìlà|fìlà
fìtílà|fìtílà
fìyà|fìjà
fífarahàn|fífarahàn
fífi|fífi
fífibú|fífibú
fífà|fífà
fífàya|fífàja
fífì|fífì
fífún|fífún
fífúnni|fífúnni
fífẹ̀|fífɛ̀
fífẹ́|fífɛ́
fífẹ́lẹ́|fífɛ́lɛ́
fífẹ́rẹ|fífɛ́rɛ
fífọ|fífɔ
fífọ́|fífɔ́
fín|fín
fínfín|fínfín
fínní|fínní
fínràn|fínràn
fíofío|fíofío
fò|fò
fònọ̀lọjí|fònɔ̀lɔd͡ʒí
fòyà|fòjà
fóòro|fóòro
fùfù|fùfù
fùú|fùú
fú|fú
fújì|fúd͡ʒì
fún|fún
fúnkẹ́|fúnkɛ́
fúnmi|fúnmi
fúnra|fúnra
fúnrúgbìn|fúnrúɡ͡bìn
fúyẹ́|fújɛ́
fẹlifẹli|fɛlifɛli
fẹlá|fɛlá
fẹnu|fɛ̃u
fẹnukò|fɛ̃ukò
fẹsẹ̀múlẹ̀|fɛsɛ̀múlɛ̀
fẹ̀|fɛ̀
fẹ̀fun|fɛ̀fũ
fẹ̀gbẹ́|fɛ̀ɡ͡bɛ́
fẹ̀sùn|fɛ̀sùn
fẹ́|fɛ́
fẹ́lẹ́fẹ́lẹ́|fɛ́lɛ́fɛ́lɛ́
fẹ́rakù|fɛ́rakù
fẹ́rakú|fɛ́rakú
fẹ́ran|fɛ́ran
fẹ́rà|fɛ́rà
fẹ́ràn|fɛ́ràn
fẹ́rànmi|fɛ́rànmi
fẹ́rànmí|fɛ́rànmí
fẹ́rẹ|fɛ́rɛ
fẹ́rẹ̀|fɛ́rɛ̀
fẹ́rẹ́sẹ́|fɛ́rɛ́sɛ́
fẹ́ẹ̀|fɛ́ɛ̀
fẹ́ẹ́rẹ́|fɛ́ɛ́rɛ́
fọhùn|fɔhùn
fọjú|fɔd͡ʒú
fọkàn|fɔkàn
fọlá|fɔlá
fọlákẹ́|fɔlákɛ́
fọlámí|fɔlámí
fọn|fɔ̃
fọnfọn|fɔ̃fɔ̃
fọnu|fɔ̃u
fọwọ́|fɔwɔ́
fọwọ́sí|fɔwɔ́sí
fọ̀|fɔ̀
fọ́|fɔ́
fọ́fọ́|fɔ́fɔ́
fọ́jú|fɔ́d͡ʒú
fọ́n|fɔ́n
fọ́nfọ́n|fɔ́nfɔ́n
fọ́nká|fɔ́nká
fọ́nká’|fɔ́nká’
fọ́nnu|fɔ́nnu
fọ́nu|fɔ́nu
fọṣọ|fɔʃɔ
fọ’bọ́|fɔ’bɔ́
fọ’nu|fɔ’nu
f’ara|f’ara
f’etí|f’etí
f’ilé|f’ilé
f’orí|f’orí
f’ìgbà|f’ìɡ͡bà
f’ònà|f’ònà
f’ẹ́ni|f’ɛ́ni
f’ọwọ́|f’ɔwɔ́
f’ọ́ba|f’ɔ́ba
f’ọ́jọ́|f’ɔ́d͡ʒɔ́
f’’ọ́ba|f’’ɔ́ba
ga|ɡa
gaan|ɡaan
gaaṣi|ɡaaʃi
gabata|ɡabata
gabrieli|ɡabrieli
gadara|ɡadara
gaderi|ɡaderi
gadi|ɡadi
gaiusi|ɡaiusi
galali|ɡalali
galatia|ɡalatia
galeedi|ɡaleedi
galili|ɡalili
galimu|ɡalimu
gallioni|ɡallioni
gamalieli|ɡamalieli
gan|ɡan
gangan’|ɡanɡan’
gannimu|ɡannimu
ganíyá|ɡaníjá
garimu|ɡarimu
gasa|ɡasa
gasesi|ɡasesi
gati|ɡati
gaàrí|ɡaàrí
gbafẹ́|ɡ͡bafɛ́
gbagada|ɡ͡baɡada
gbajúmọ̀|ɡ͡bad͡ʒúmɔ̀
gbangba|ɡ͡banɡ͡ba
gbani|ɡ͡bani
gbara|ɡ͡bara
gbayì|ɡ͡bajì
gbilẹ̀|ɡ͡bilɛ̀
gbin|ɡ͡bĩ
gbinlẹ̀|ɡ͡bĩlɛ̀
gbiná|ɡ͡bĩá
gbinájẹ|ɡ͡bĩád͡ʒɛ
gbiri|ɡ͡biri
gbodọ̀|ɡ͡bodɔ̀
gbogbo|ɡ͡boɡ͡bo
gbolẹ̀|ɡ͡bolɛ̀
gboyè|ɡ͡bojè
gbà|ɡ͡bà
gbàbé|ɡ͡bàbé
gbàdúrà|ɡ͡bàdúrà
gbàgbé|ɡ͡bàɡ͡bé
gbàgbó|ɡ͡bàɡ͡bó
gbàgbọ́|ɡ͡bàɡ͡bɔ́
gbàgbọ́bí|ɡ͡bàɡ͡bɔ́bí
gbàgbọ́’|ɡ͡bàɡ͡bɔ́’
gbàjarè|ɡ͡bàd͡ʒarè
gbàlà|ɡ͡bàlà
gbàlà’|ɡ͡bàlà’
gbàmí|ɡ͡bàmí
gbàngàn|ɡ͡bànɡàn
gbààwẹ̀|ɡ͡bààwɛ̀
gbàǹgbà|ɡ͡bàǹɡ͡bà
gbàǹja|ɡ͡bàǹd͡ʒa
gbàǹjà|ɡ͡bàǹd͡ʒà
gbà’|ɡ͡bà’
gbá|ɡ͡bá
gbáa|ɡ͡báa
gbádun|ɡ͡bádũ
gbádébọ|ɡ͡bádébɔ
gbádùn|ɡ͡bádùn
gbáko|ɡ͡báko
gbámú|ɡ͡bámú
gbámúṣé|ɡ͡bámúʃé
gbára|ɡ͡bára
gbárajọ|ɡ͡bárad͡ʒɔ
gbárayílẹ̀|ɡ͡bárajílɛ̀
gbáà|ɡ͡báà
gbè|ɡ͡bè
gbèdéke|ɡ͡bèdéke
gbèjà|ɡ͡bèd͡ʒà
gbèmí|ɡ͡bèmí
gbère|ɡ͡bère
gbèrò|ɡ͡bèrò
gbèrú|ɡ͡bèrú
gbèsè|ɡ͡bèsè
gbé|ɡ͡bé
gbée|ɡ͡bée
gbéga|ɡ͡béɡa
gbélẹ̀|ɡ͡bélɛ̀
gbénga|ɡ͡bénɡa
gbénró|ɡ͡bénró
gbéra|ɡ͡béra
gbéraga|ɡ͡béraɡa
gbére|ɡ͡bére
gbéró|ɡ͡béró
gbéyàwó|ɡ͡béjàwó
gbéṣẹ́|ɡ͡béʃɛ́
gbìmọ̀|ɡ͡bìmɔ̀
gbìmọ̀ràn|ɡ͡bìmɔ̀ràn
gbìn|ɡ͡bìn
gbìn’|ɡ͡bìn’
gbìyànjú|ɡ͡bìjànd͡ʒú
gbígba|ɡ͡bíɡ͡ba
gbígbà|ɡ͡bíɡ͡bà
gbígbàgbọ́|ɡ͡bíɡ͡bàɡ͡bɔ́
gbígbààwẹ̀|ɡ͡bíɡ͡bààwɛ̀
gbígbá|ɡ͡bíɡ͡bá
gbígbé|ɡ͡bíɡ͡bé
gbígbéga|ɡ͡bíɡ͡béɡa
gbígbékọ́|ɡ͡bíɡ͡békɔ́
gbígbéra|ɡ͡bíɡ͡béra
gbígbéró|ɡ͡bíɡ͡béró
gbígbìn|ɡ͡bíɡ͡bìn
gbígbòòrò|ɡ͡bíɡ͡bòòrò
gbígbóná|ɡ͡bíɡ͡bóná
gbígbẹ|ɡ͡bíɡ͡bɛ
gbígbẹ́|ɡ͡bíɡ͡bɛ́
gbígbọ́|ɡ͡bíɡ͡bɔ́
gbíngbin|ɡ͡bínɡ͡bĩ
gbíyànjù|ɡ͡bíjànd͡ʒù
gbòò|ɡ͡bòò
gbòòrò|ɡ͡bòòrò
gbòógì|ɡ͡bòóɡì
gbòǹgbò|ɡ͡bòǹɡ͡bò
gbó|ɡ͡bó
gbógun|ɡ͡bóɡũ
gbóguntì|ɡ͡bóɡũtì
gbóhùn|ɡ͡bóhùn
gbójú|ɡ͡bód͡ʒú
gbólóhùn|ɡ͡bólóhùn
gbólúwaga|ɡ͡bólúwaɡa
gbómi|ɡ͡bómi
gbóná|ɡ͡bóná
gbóògun|ɡ͡bóòɡũ
gbó’gun|ɡ͡bó’ɡũ
gbùngbùn|ɡ͡bùnɡ͡bùn
gbún|ɡ͡bún
gbúròó|ɡ͡búròó
gbẹ|ɡ͡bɛ
gbẹ̀du|ɡ͡bɛ̀du
gbẹ̀san|ɡ͡bɛ̀san
gbẹ̀yin|ɡ͡bɛ̀jĩ
gbẹ̀yìn|ɡ͡bɛ̀jìn
gbẹ̀yẹ|ɡ͡bɛ̀jɛ
gbẹ́|ɡ͡bɛ́
gbẹ́bẹ̀|ɡ͡bɛ́bɛ̀
gbẹ́gi|ɡ͡bɛ́ɡi
gbẹ́kẹ̀|ɡ͡bɛ́kɛ̀
gbẹ́kẹ̀lé|ɡ͡bɛ́kɛ̀lé
gbẹ́nu|ɡ͡bɛ́nu
gbẹ́nàgbẹ́nà|ɡ͡bɛ́nàɡ͡bɛ́nà
gbẹ́sẹ̀|ɡ͡bɛ́sɛ̀
gbọdọ̀|ɡ͡bɔdɔ̀
gbọgbẹ́|ɡ͡bɔɡ͡bɛ́
gbọingbọin|ɡ͡bɔĩɡ͡bɔĩ
gbọn|ɡ͡bɔ̃
gbọningbọnin|ɡ͡bɔ̃ĩɡ͡bɔ̃ĩ
gbọ̀gàn|ɡ͡bɔ̀ɡàn
gbọ̀gán|ɡ͡bɔ̀ɡán
gbọ̀n|ɡ͡bɔ̀n
gbọ̀ngàn|ɡ͡bɔ̀nɡàn
gbọ̀nọ́ngbọ̀nọ́n|ɡ͡bɔ̀nɔ́nɡ͡bɔ̀nɔ́n
gbọ́|ɡ͡bɔ́
gbọ́fá|ɡ͡bɔ́fá
gbọ́jà|ɡ͡bɔ́d͡ʒà
gbọ́kò|ɡ͡bɔ́kò
gbọ́n|ɡ͡bɔ́n
gbọ́ngungbọ̀ngun|ɡ͡bɔ́nɡũɡ͡bɔ̀nɡũ
gbọ́nmi|ɡ͡bɔ́nmi
gbọ́ní|ɡ͡bɔ́ní
gbọ́ran|ɡ͡bɔ́ran
gbọ́ràn|ɡ͡bɔ́ràn
gbọ́rọ̀|ɡ͡bɔ́rɔ̀
gbọ́wọ́|ɡ͡bɔ́wɔ́
gbọ́’|ɡ͡bɔ́’
gbọọrọ|ɡ͡bɔɔrɔ
gb’omi|ɡ͡b’omi
gb’owó|ɡ͡b’owó
gb’ẹ̀bẹ̀|ɡ͡b’ɛ̀bɛ̀
ge|ɡe
geba|ɡeba
gebali|ɡebali
geberi|ɡeberi
gedaliah|ɡedaliah
gedegbe|ɡedeɡ͡be
gederi|ɡederi
gederoti|ɡederoti
gedori|ɡedori
geere|ɡeere
geharaṣinu|ɡeharaʃĩu
gehasi|ɡehasi
geliloti|ɡeliloti
gemariah|ɡemariah
genesareti|ɡenesareti
gera|ɡera
gerari|ɡerari
geruti|ɡeruti
gerṣomu|ɡerʃomu
gerṣoni|ɡerʃoni
geseri|ɡeseri
getsemane|ɡetsemane
geṣuri|ɡeʃuri
gibeah|ɡibeah
gibeoni|ɡibeoni
gibetoni|ɡibetoni
gideoni|ɡideoni
gidi|ɡidi
gidigidi|ɡidiɡidi
gilalai|ɡilalai
gileadi|ɡileadi
gilgali|ɡilɡali
giloni|ɡiloni
gimiso|ɡimiso
girama|ɡirama
gireepu|ɡireek͡pu
girgaṣi|ɡirɡaʃi
giriki|ɡiriki
gisoni|ɡisoni
gitti|ɡitti
gittiti|ɡittiti
gogoro|ɡoɡoro
gogu|ɡoɡu
golani|ɡolani
goliati|ɡoliati
gomeri|ɡomeri
gomorra|ɡomorra
gooro|ɡooro
gorí|ɡorí
gosani|ɡosani
goṣeni|ɡoʃeni
go’owó|ɡo’owó
gun|ɡũ
guni|ɡũi
gur|ɡur
gàba|ɡàba
gàdàgbà|ɡàdàɡ͡bà
gàn|ɡàn
gàní|ɡàní
gàràgà|ɡàràɡà
gààrí|ɡààrí
gàárì|ɡàárì
gáfárà|ɡáfárà
gán|ɡán
gángan|ɡánɡan
gègé|ɡèɡé
gèlè|ɡèlè
gé|ɡé
gégùn|ɡéɡùn
géètì|ɡéètì
gìgísẹ̀|ɡìɡísɛ̀
gìrì|ɡìrì
gììrì|ɡììrì
gíga|ɡíɡa
gígàn|ɡíɡàn
gígé|ɡíɡé
gígùn|ɡíɡùn
gírí|ɡírí
gírígírí|ɡíríɡírí
gòkè|ɡòkè
gómìnà|ɡómìnà
góńgó|ɡóńɡó
gùn|ɡùn
gùnlé|ɡùnlé
gúgúrú|ɡúɡúrú
gún|ɡún
gúnlẹ̀|ɡúnlɛ̀
gúnugún|ɡúnuɡún
gúnwà|ɡúnwà
gúsù|ɡúsù
gúúsù|ɡúúsù
gẹdú|ɡɛdú
gẹ̀|ɡɛ̀
gẹ̀lẹ̀dẹ́|ɡɛ̀lɛ̀dɛ́
gẹ̀rẹ̀|ɡɛ̀rɛ̀
gẹ̀rẹ́gẹ̀rẹ́|ɡɛ̀rɛ́ɡɛ̀rɛ́
gẹ̀ẹ́si|ɡɛ̀ɛ́si
gẹ̀ẹ́sì|ɡɛ̀ɛ́sì
gẹ́|ɡɛ́
gẹ́gẹ́|ɡɛ́ɡɛ́
gẹ́lẹ́|ɡɛ́lɛ́
gẹ́rẹ́|ɡɛ́rɛ́
gẹ́ẹ́|ɡɛ́ɛ́
gẹṣin|ɡɛʃĩ
gẹ’run|ɡɛ’rũ
gọgọwú|ɡɔɡɔwú
gọlgọta|ɡɔlɡɔta
gọ̀|ɡɔ̀
gọ̀m̀bọ̀|ɡɔ̀m̀bɔ̀
gọ̀ǹgọ̀|ɡɔ̀ǹɡɔ̀
gọ́tà|ɡɔ́tà
ha|ha
haapu|haak͡pu
habasiniah|habasĩiah
habori|habori
hadadeseri|hadadeseri
hadadi|hadadi
hadassa|hadassa
hagai|haɡai
hagari|haɡari
haggi|haɡɡi
haggidgadi|haɡɡidɡadi
haggiti|haɡɡiti
hahirotu|hahirotu
hajj|had͡ʒd͡ʒ
hakosi|hakosi
hala|hala
halloheṣi|halloheʃi
halẹ̀|halɛ̀
hamani|hamani
hamati|hamati
hameleki|hameleki
hamid|hamid
hammedata|hammedata
hammoni|hammoni
hamoni|hamoni
hamori|hamori
hamu|hamu
hamulu|hamulu
han|han
hanameli|hanameli
hananeli|hananeli
hanani|hanani
hananiah|hananiah
hanoku|hanoku
hanuni|hanũi
harani|harani
harari|harari
harefu|harefu
hareseti|hareseti
harhasi|harhasi
harhiah|harhiah
harodi|harodi
haroditi|haroditi
haroe|haroe
harori|harori
harṣa|harʃa
hasaeli|hasaeli
hasari|hasari
hasieli|hasieli
hasori|hasori
hataki|hataki
hatifa|hatifa
hatikonu|hatikonu
haurani|haurani
haṣabiah|haʃabiah
haṣbneiah|haʃbneiah
haṣemu|haʃemu
haṣi|haʃi
haṣmona|haʃmona
haṣubu|haʃubu
heberi|heberi
heberu|heberu
hebroni|hebroni
heferi|heferi
hegai|heɡai
helami|helami
helba|helba
heledi|heledi
helefi|helefi
helesi|helesi
helleni|helleni
heloni|heloni
hemani|hemani
hena|hena
henadadi|henadadi
herbert|herbert
hereki|hereki
heresi|heresi
herma|herma
hermesi|hermesi
hermoni|hermoni
herodia|herodia
herodioni|herodioni
herodu|herodu
hesekiah|hesekiah
hesioni|hesioni
hesitation|hesitation
hesroni|hesroni
heṣboni|heʃboni
hifi|hifi
hileli|hileli
hilkiah|hilkiah
himeneu|himeneu
hinnomu|hĩnomu
hira|hira
hiramu|hiramu
hirapoli|hirak͡poli
hiti|hiti
hnatoni|hnatoni
hoba|hoba
hobabu|hobabu
hodafiah|hodafiah
hodiah|hodiah
hodṣi|hodʃi
hofira|hofira
hogla|hoɡla
hohamu|hohamu
hohùn|hohùn
homamu|homamu
homeri|homeri
horebu|horebu
horeṣi|horeʃi
hori|hori
horma|horma
hormah|hormah
horonaimu|horonaimu
horoni|horoni
hosa|hosa
hosana|hosana
hose|hose
hosea|hosea
hoògùn|hoòɡùn
hoṣaiah|hoʃaiah
hu|hu
hufamu|hufamu
hukoki|hukoki
hulda|hulda
hun|hũ
huppimu|huk͡pk͡pimu
huramu|huramu
huri|huri
huṣai|huʃai
huṣati|huʃati
huṣimu|huʃimu
hà|hà
hàn|hàn
hàì|hàì
há|há
hámọ́ra|hámɔ́ra
hángógó|hánɡóɡó
háà|háà
hé|hé
híhu|híhu
híhun|híhũ
híhó|híhó
híhù|híhù
híhún|híhún
hínì|hínì
hísópù|hísók͡pù
hó|hó
hóró|hóró
hósítẹ̀lì|hósítɛ̀lì
hù|hù
hùrùhẹrẹ|hùrùhɛrɛ
hùwà|hùwà
hú|hú
hẹlẹ|hɛlɛ
i|i
ibi|ibi
ibiiṣẹ́|ibiiʃɛ́
ibikíbi|ibikíbi
ibiṣẹ́|ibiʃɛ́
ibi’ṣẹ́|ibi’ʃɛ́
ibodè|ibodè
ibojì|ibod͡ʒì
ibà|ibà
ibìkan|ibìkan
ibìkankan|ibìkankan
ibí|ibí
ibòji|ibòd͡ʒi
ibòmíràn|ibòmíràn
ibòòji|ibòòd͡ʒi
ibùba|ibùba
ibùdó|ibùdó
ibùdókọ̀|ibùdókɔ̀
ibùgbé|ibùɡ͡bé
ibùjókòó|ibùd͡ʒókòó
ibùjẹ|ibùd͡ʒɛ
ibùso|ibùso
ibùsùn|ibùsùn
ibùsọ̀|ibùsɔ̀
ibú|ibú
ibẹ̀|ibɛ̀
idala|idala
idayìí|idajìí
iddo|iddo
idumea|idumea
idà|idà
idàkídà|idàkídà
idán|idán
idì|idì
idílé|idílé
iffa|iffa
ifita|ifita
ifá|ifá
ifálékè|ifálékè
ifẹ̀|ifɛ̀
iga|iɡa
igbe|iɡ͡be
igbá|iɡ͡bá
igbákejì|iɡ͡báked͡ʒì
igbó|iɡ͡bó
igi|iɡi
igikígi|iɡikíɡi
igimú|iɡimú
igà|iɡà
igàn|iɡàn
igún|iɡún
igúnnugún|iɡúnnuɡún
igẹ̀|iɡɛ̀
iho|iho
ihò|ihò
ijà|id͡ʒà
ijó|id͡ʒó
ijù|id͡ʒù
ijọ́|id͡ʒɔ́
ikoniomu|ikoniomu
ikun’mú|ikũ’mú
ikán|ikán
iké|iké
ikùn|ikùn
ikú|ikú
ikún|ikún
ikúu|ikúu
ikọ̀|ikɔ̀
ikọ́|ikɔ́
illirikoni|illirikoni
ilà|ilà
ilè|ilè
ilé|ilé
ilédélé|ilédélé
ilée|ilée
iléelẹ̀|iléelɛ̀
ilékílé|ilékílé
ilémobọ́lá|ilémobɔ́lá
ilésanmí|ilésanmí
iléyá|iléjá
iléèwé|iléèwé
ilé’|ilé’
ilú|ilú
ilẹ̀|ilɛ̀
ilẹ̀kùn|ilɛ̀kùn
ilẹ̀ẹ|ilɛ̀ɛ
immeri|immeri
imri|imri
imí|imí
imú|imú
imọ̀|imɔ̀
inu|ĩu
inuwọ̀|ĩuwɔ̀
iná|ĩá
inú|ĩú
inúnibíni|ĩúnibíni
inúu|ĩúu
ipa|ik͡pa
ipadò|ik͡padò
ipasẹ̀|ik͡pasɛ̀
ipele|ik͡pele
ipá|ik͡pá
ipò|ik͡pò
ipòkípò|ik͡pòkík͡pò
ire|ire
irin|irĩ
irinwó|irĩwó
irinwó|irĩwó
irinṣẹ́|irĩʃɛ́
iré|iré
irùngbọ̀n|irùnɡ͡bɔ̀n
irú|irú
irúgbìn|irúɡ͡bìn
irọ̀|irɔ̀
irọ́|irɔ́
isaaki|isaaki
isaiah|isaiah
isakari|isakari
isari|isari
isiah|isiah
iskariotu|iskariotu
israẹli|israɛli
isà|isà
isó|isó
isẹ́|isɛ́
itali|itali
itamari|itamari
itasi|itasi
itreamu|itreamu
itri|itri
ittai|ittai
iturea|iturea
itọ́|itɔ́
iwàlọlá|iwàlɔlá
iwájú|iwád͡ʒú
iyanrìn|ijanrìn
iye|ije
iyebiye|ijebije
iyebíye|ijebíje
iyàn|ijàn
iyàrá|ijàrá
iyá|ijá
iyán|iján
iyè|ijè
iyèkan|ijèkan
iyèméjì|ijèméd͡ʒì
iyé|ijé
iyì|ijì
iyùn|ijùn
iyẹ̀pẹ̀|ijɛ̀k͡pɛ̀
iyọ̀|ijɔ̀
iójú|iód͡ʒú
iṣan|iʃan
iṣboṣeti|iʃboʃeti
iṣi|iʃi
iṣifi|iʃifi
iṣmaeli|iʃmaeli
iṣé|iʃé
iṣẹ́|iʃɛ́
iṣẹ́kíṣẹ́|iʃɛ́kíʃɛ́
i’|i’
ja|d͡ʒa
jaakani|d͡ʒaakani
jaani|d͡ʒaani
jaaṣaniah|d͡ʒaaʃaniah
jabbok|d͡ʒabbok
jabesi|d͡ʒabesi
jabini|d͡ʒabĩi
jabne|d͡ʒabne
jabneeli|d͡ʒabneeli
jada|d͡ʒada
jaddua|d͡ʒaddua
jadoni|d͡ʒadoni
jaeli|d͡ʒaeli
jafani|d͡ʒafani
jafeti|d͡ʒafeti
jafia|d͡ʒafia
jafileti|d͡ʒafileti
jagun|d͡ʒaɡũ
jagunjagun|d͡ʒaɡũd͡ʒaɡũ
jaguri|d͡ʒaɡuri
jahasi|d͡ʒahasi
jahasieli|d͡ʒahasieli
jahati|d͡ʒahati
jahdieli|d͡ʒahdieli
jairi|d͡ʒairi
jairu|d͡ʒairu
jakali|d͡ʒakali
jakini|d͡ʒakĩi
jakinti|d͡ʒakĩti
jakọbu|d͡ʒakɔbu
jakọbu’|d͡ʒakɔbu’
jalabíà|d͡ʒalabíà
jalamu|d͡ʒalamu
jaleeli|d͡ʒaleeli
jalè|d͡ʒalè
jamberi|d͡ʒamberi
jamini|d͡ʒamĩi
janai|d͡ʒanai
janesi|d͡ʒanesi
janoa|d͡ʒanoa
jaredi|d͡ʒaredi
jariha|d͡ʒariha
jarmatu|d͡ʒarmatu
jaseeli|d͡ʒaseeli
jaseri|d͡ʒaseri
jasieli|d͡ʒasieli
jasoni|d͡ʒasoni
jasperi|d͡ʒask͡peri
jayé|d͡ʒajé
jayéjayé|d͡ʒajéd͡ʒajé
jaṣubu|d͡ʒaʃubu
jearimu|d͡ʒearimu
jeberekiah|d͡ʒeberekiah
jebusi|d͡ʒebusi
jedaiah|d͡ʒedaiah
jediaeli|d͡ʒediaeli
jedutuni|d͡ʒedutũi
jefta|d͡ʒefta
jefunne|d͡ʒefũne
jegari|d͡ʒeɡari
jehiah|d͡ʒehiah
jehieli|d͡ʒehieli
jehoahasi|d͡ʒehoahasi
jehoaṣi|d͡ʒehoaʃi
jehohanani|d͡ʒehohanani
jehoiada|d͡ʒehoiada
jehoiakimu|d͡ʒehoiakimu
jehoiakini|d͡ʒehoiakĩi
jehoida|d͡ʒehoida
jehonadabu|d͡ʒehonadabu
jehoramu|d͡ʒehoramu
jehoṣafati|d͡ʒehoʃafati
jehu|d͡ʒehu
jeieli|d͡ʒeieli
jekameamu|d͡ʒekameamu
jekoniah|d͡ʒekoniah
jerahmeeli|d͡ʒerahmeeli
jeremiah|d͡ʒeremiah
jeriah|d͡ʒeriah
jeriko|d͡ʒeriko
jerimoti|d͡ʒerimoti
jeroboamu|d͡ʒeroboamu
jerohamu|d͡ʒerohamu
jerueli|d͡ʒerueli
jerusalẹmu|d͡ʒerusalɛmu
jeruṣa|d͡ʒeruʃa
jesaniah|d͡ʒesaniah
jese|d͡ʒese
jesebeli|d͡ʒesebeli
jesreeli|d͡ʒesreeli
jesu|d͡ʒesu
jeteri|d͡ʒeteri
jetro|d͡ʒetro
jeturi|d͡ʒeturi
jeun|d͡ʒeũ
jeuṣi|d͡ʒeuʃi
jeṣaiah|d͡ʒeʃaiah
jeṣua|d͡ʒeʃua
jeṣuruni|d͡ʒeʃurũi
jini|d͡ʒĩi
jinlẹ̀|d͡ʒĩlɛ̀
jiyàn|d͡ʒijàn
jo|d͡ʒo
joabu|d͡ʒoabu
joah|d͡ʒoah
joana|d͡ʒoana
joanna|d͡ʒoanna
joaṣi|d͡ʒoaʃi
jobu|d͡ʒobu
joda|d͡ʒoda
jogli|d͡ʒoɡli
jogún|d͡ʒoɡún
johanani|d͡ʒohanani
johanu|d͡ʒohanu
joiada|d͡ʒoiada
jojo|d͡ʒod͡ʒo
jokebedi|d͡ʒokebedi
jokimeamu|d͡ʒokimeamu
jokneamu|d͡ʒokneamu
joktani|d͡ʒoktani
jokṣani|d͡ʒokʃani
jona|d͡ʒona
jonamu|d͡ʒonamu
jonatani|d͡ʒonatani
joppa|d͡ʒok͡pk͡pa
joramu|d͡ʒoramu
jordani|d͡ʒordani
jorimu|d͡ʒorimu
jorkeamu|d͡ʒorkeamu
joró|d͡ʒoró
josabadi|d͡ʒosabadi
josadaki|d͡ʒosadaki
jose|d͡ʒose
josiah|d͡ʒosiah
josẹfu|d͡ʒosɛfu
jotamu|d͡ʒotamu
jotbata|d͡ʒotbata
jowú|d͡ʒowú
joyè|d͡ʒojè
joẹli|d͡ʒoɛli
ju|d͡ʒu
jubali|d͡ʒubali
juda|d͡ʒuda
judasi|d͡ʒudasi
judea|d͡ʒudea
juditi|d͡ʒuditi
julia|d͡ʒulia
juliusi|d͡ʒuliusi
junia|d͡ʒũia
junifa|d͡ʒũifa
jupiteri|d͡ʒuk͡piteri
justu|d͡ʒustu
jutta|d͡ʒutta
juwọ́|d͡ʒuwɔ́
juùyà|d͡ʒuùjà
jà|d͡ʒà
jàdídùn|d͡ʒàdídùn
jàgídíjàgan|d͡ʒàɡídíd͡ʒàɡan
jàlabíà|d͡ʒàlabíà
jànkanjànkàn|d͡ʒànkand͡ʒànkàn
jàre|d͡ʒàre
jàńtìrẹrẹ|d͡ʒàńtìrɛrɛ
jàǹdùkú|d͡ʒàǹdùkú
já|d͡ʒá
jábọ̀|d͡ʒábɔ̀
jábọ́|d͡ʒábɔ́
jáde|d͡ʒáde
jáfara|d͡ʒáfara
jáfáfá|d͡ʒáfáfá
jákànde|d͡ʒákànde
jákèjádò|d͡ʒákèd͡ʒádò
jákọ́bù|d͡ʒákɔ́bù
jálá|d͡ʒálá
jáláyà|d͡ʒálájà
jálẹ̀|d͡ʒálɛ̀
jámọ́|d͡ʒámɔ́
járọ́ọ|d͡ʒárɔ́ɔ
jásí|d͡ʒásí
játijàti|d͡ʒátid͡ʒàti
játọ́|d͡ʒátɔ́
jáwé|d͡ʒáwé
jáwọ́|d͡ʒáwɔ́
jáyà|d͡ʒájà
jáńtìrẹrẹ|d͡ʒáńtìrɛrɛ
jèhóvà|d͡ʒèhóvà
jèrè|d͡ʒèrè
jé|d͡ʒé
jéró|d͡ʒéró
jésù|d͡ʒésù
jì|d͡ʒì
jìjàdù|d͡ʒìd͡ʒàdù
jìjàkadì|d͡ʒìd͡ʒàkadì
jìn|d͡ʒìn
jìnnà|d͡ʒìnnà
jìnnàjìnnà|d͡ʒìnnàd͡ʒìnnà
jìnnìjìnnì|d͡ʒìnnìd͡ʒìnnì
jìnà|d͡ʒìnà
jìnádù|d͡ʒìnádù
jìtá|d͡ʒìtá
jìyà|d͡ʒìjà
jì́nà|d͡ʒì́nà
jìṣẹ́|d͡ʒìʃɛ́
jí|d͡ʒí
jíbádé|d͡ʒíbádé
jíbówú|d͡ʒíbówú
jíbọ́lá|d͡ʒíbɔ́lá
jídé|d͡ʒídé
jíire|d͡ʒíire
jíjiyàn|d͡ʒíd͡ʒijàn
jíju|d͡ʒíd͡ʒu
jíjà|d͡ʒíd͡ʒà
jíjáde|d͡ʒíd͡ʒáde
jíjìn|d͡ʒíd͡ʒìn
jíjìnnà|d͡ʒíd͡ʒìnnà
jíjìyà|d͡ʒíd͡ʒìjà
jíjí|d͡ʒíd͡ʒí
jíjó|d͡ʒíd͡ʒó
jíjóná|d͡ʒíd͡ʒóná
jíjẹ|d͡ʒíd͡ʒɛ
jíjẹ́|d͡ʒíd͡ʒɛ́
jímọ̀|d͡ʒímɔ̀
jíngírí|d͡ʒínɡírí
jíròrò|d͡ʒíròrò
jíyìn|d͡ʒíjìn
jíǹde|d͡ʒíǹde
jíǹde’|d͡ʒíǹde’
jíǹkí|d͡ʒíǹkí
jíṣẹ́|d͡ʒíʃɛ́
jó|d͡ʒó
jókòó|d͡ʒókòó
jóni|d͡ʒóni
jóná|d͡ʒóná
jórun|d͡ʒórũ
jù|d͡ʒù
jùlọ|d͡ʒùlɔ
jùmọ̀|d͡ʒùmɔ̀
jùwọ́n|d͡ʒùwɔ́n
jùyà|d͡ʒùjà
jùú|d͡ʒùú
jú|d͡ʒú
júbà|d͡ʒúbà
júfù|d͡ʒúfù
júujùu|d͡ʒúud͡ʒùu
júwe|d͡ʒúwe
júù|d͡ʒúù
júù’|d͡ʒúù’
j̣ẹ|d͡ʒ̣ɛ
jẹ|d͡ʒɛ
jẹmí|d͡ʒɛmí
jẹrun|d͡ʒɛrũ
jẹun|d͡ʒɛũ
jẹun’|d͡ʒɛũ’
jẹyọ|d͡ʒɛjɔ
jẹyọ̀|d͡ʒɛjɔ̀
jẹ̀bi|d͡ʒɛ̀bi
jẹ̀díjẹ̀dí|d͡ʒɛ̀díd͡ʒɛ̀dí
jẹ̀jẹ̀|d͡ʒɛ̀d͡ʒɛ̀
jẹ̀lílì|d͡ʒɛ̀lílì
jẹ̀mílá|d͡ʒɛ̀mílá
jẹ̀’ka|d͡ʒɛ̀’ka
jẹ́|d͡ʒɛ́
jẹ́jẹ́|d͡ʒɛ́d͡ʒɛ́
jẹ́jọ́|d͡ʒɛ́d͡ʒɔ́
jẹ́lú|d͡ʒɛ́lú
jẹ́rìí|d͡ʒɛ́rìí
jẹ́wọ́|d͡ʒɛ́wɔ́
jẹ́ẹ́|d͡ʒɛ́ɛ́
jẹ́ẹ́jẹ́|d͡ʒɛ́ɛ́d͡ʒɛ́
jẹ́’|d͡ʒɛ́’
jẹ’|d͡ʒɛ’
jẹ’kà|d͡ʒɛ’kà
jọ|d͡ʒɔ
jọba|d͡ʒɔba
jọjú|d͡ʒɔd͡ʒú
jọjọ|d͡ʒɔd͡ʒɔ
jọláadé|d͡ʒɔláadé
jọra|d͡ʒɔra
jọ̀|d͡ʒɔ̀
jọ̀jọ̀|d͡ʒɔ̀d͡ʒɔ̀
jọ̀kan|d͡ʒɔ̀kan
jọ̀kújọ̀kú|d͡ʒɔ̀kúd͡ʒɔ̀kú
jọ̀run|d͡ʒɔ̀rũ
jọ̀wọ́|d͡ʒɔ̀wɔ́
jọ̀ọ́|d͡ʒɔ̀ɔ́
jọ́|d͡ʒɔ́
jọ́ba|d͡ʒɔ́ba
jọ́sìn|d͡ʒɔ́sìn
j’íṣẹ́|d͡ʒ’íʃɛ́
j’òkuta|d͡ʒ’òkuta
j’̣ọba|d͡ʒ’̣ɔba
j’ọba|d͡ʒ’ɔba
k|k
ka|ka
kabulu|kabulu
kabṣeeli|kabʃeeli
kadeṣi|kadeʃi
kadmieli|kadmieli
kafitori|kafitori
kaiafa|kaiafa
kainani|kaĩani
kaini|kaĩi
kalamusi|kalamusi
kaldea|kaldea
kalebu|kalebu
kalifóníà|kalifóníà
kalkedoni|kalkedoni
kalẹ̀|kalɛ̀
kan|kan
kana|kana
kandake|kandake
kaneliani|kaneliani
kankan|kankan
kanlẹ̀|kanlɛ̀
kannáà|kannáà
kannítorí|kannítorí
kanra|kanra
kanrí|kanrí
kantíkantí|kantíkantí
kanáà|kanáà
kan’|kan’
kapernaumu|kak͡pernaumu
kappadokia|kak͡pk͡padokia
karea|karea
karisoliti|karisoliti
karmeli|karmeli
karmi|karmi
karpu|kark͡pu
karùn|karùn
kasia|kasia
kasifia|kasifia
kasitoru|kasitoru
katati|katati
kauda|kauda
kawó|kawó
kaánà|kaánà
kaṣini|kaʃĩi
kebari|kebari
kedari|kedari
kedema|kedema
kedemoti|kedemoti
kedere|kedere
kedeṣi|kedeʃi
kedorlaomeri|kedorlaomeri
kefa|kefa
kehelata|kehelata
keila|keila
keje|ked͡ʒe
kejilelogun|ked͡ʒileloɡũ
kejì|ked͡ʒì
kejìdínlógójì|ked͡ʒìdínlóɡód͡ʒì
kejìdínlógún|ked͡ʒìdínlóɡún
kejìlá|ked͡ʒìlá
kejìléláàádọ́ta|ked͡ʒìléláàádɔ́ta
keke|keke
kemoṣi|kemoʃi
kenaana|kenaana
kenaani|kenaani
kenani|kenani
kenaniah|kenaniah
kenasi|kenasi
keni|keni
kenissiti|kenissiti
kenkerea|kenkerea
kenny|kennj
kereti|kereti
kerioti|kerioti
kerubu|kerubu
kesarea|kesarea
kesari|kesari
kesibu|kesibu
ketekete|ketekete
keéjìdílógún|keéd͡ʒìdílóɡún
keétàdílógún|keétàdílóɡún
keṣiṣi|keʃiʃi
kidironi|kidironi
kidoni|kidoni
kilaudiu|kilaudiu
kileopa|kileok͡pa
kilikia|kilikia
kilopa|kilok͡pa
kimbali|kimbali
kimhamu|kimhamu
kin|kĩ
kinamoni|kĩamoni
kiní|kĩí
kiníyẹn|kĩíjɛ̃
kiosi|kiosi
kirene|kirene
kiri|kiri
kiriataimu|kiriataimu
kiriati|kiriati
kirisitali|kirisitali
kirisoleti|kirisoleti
kirusi|kirusi
kisiloti|kisiloti
kittimu|kittimu
kiṣi|kiʃi
kiṣioni|kiʃioni
klaudia|klaudia
klementi|klementi
knidu|knidu
koa|koa
kodoro|kodoro
kodò|kodò
kofí|kofí
kogún|koɡún
kohati|kohati
kojú|kod͡ʒú
kokoko|kokoko
koli|koli
kolose|kolose
koniah|koniah
koná|koná
kooro|kooro
kora|kora
korasini|korasĩi
korianderi|korianderi
korneliu|korneliu
korobá|korobá
koríko|koríko
korò|korò
kosamu|kosamu
kosi|kosi
koókàndílógún|koókàndílóɡún
ko’ná|ko’ná
krete|krete
krisipu|krisik͡pu
kristali|kristali
kristi|kristi
kristiani|kristiani
kristi’|kristi’
krìstẹ́nì|krìstɛ́nì
ku|ku
kuartu|kuartu
kumini|kumĩi
kun|kũ
kunkun|kũkũ
kusa|kusa
kuumití|kuumití
kuṣi|kuʃi
ku’lẹ̀|ku’lɛ̀
kwá|kwá
kà|kà
kàb|kàb
kàbùkù|kàbùkù
kàdúná|kàdúná
kàfáyá|kàfájá
kàkà|kàkà
kàkàkà|kàkàkà
kàn|kàn
kànga|kànɡa
kànkan|kànkan
kànkùn|kànkùn
kànlẹ̀kùun|kànlɛ̀kùũ
kànnàkànnà|kànnàkànnà
kànìnkànìn|kànìnkànìn
kàrún|kàrún
kàrúndinlogun|kàrúndĩloɡũ
kàtàkàtà|kàtàkàtà
kàwé|kàwé
kàyéfi|kàjéfi
kàǹkan|kàǹkan
kà’wé|kà’wé
ká|ká
kábíyèsí|kábíjèsí
kádàrá|kádàrá
kádírì|kádírì
kádírí|kádírí
kájọlà|kád͡ʒɔlà
káká|káká
kákò|kákò
kálámù|kálámù
kálẹ̀|kálɛ̀
kán|kán
kángun|kánɡũ
kánjú|kánd͡ʒú
kánkán|kánkán
kárakára|kárakára
kárí|kárí
káróunwí|káróũwí
kásowọ́pọ̀|kásowɔ́k͡pɔ̀
kásẹ̀|kásɛ̀
kátikàti|kátikàti
káwọ́|káwɔ́
káyé|kájé
káà|káà
káàkiri|káàkiri
káàánú|káàánú
káàárẹ̀|káàárɛ̀
káàárọ̀|káàárɔ̀
káṣọpẹ́|káʃɔk͡pɛ́
kèfèrí|kèfèrí
kèje|kèd͡ʒe
kèjì|kèd͡ʒì
kèjìlá|kèd͡ʒìlá
kèké|kèké
kèrémí|kèrémí
ké|ké
kéde|kéde
kégbe|kéɡ͡be
kékeké|kékeké
kékeré|kékeré
kékèké|kékèké
kérora|kérora
kéré|kéré
kérésì|kérésì
kérúbù|kérúbù
kétu|kétu
kété|kété
kéékèèké|kéékèèké
kì|kì
kìjikìji|kìd͡ʒikìd͡ʒi
kìkì|kìkì
kìkìdá|kìkìdá
kìlọ̀|kìlɔ̀
kìn|kìn
kìnnìún|kìnnìún
kìtìtìtì|kìtìtìtì
kìí|kìí
kí|kí
kíbúra|kíbúra
kífá|kífá
kígbe|kíɡ͡be
kíka|kíka
kíkan|kíkan
kíkankíkan|kíkankíkan
kíkoná|kíkoná
kíkorò|kíkorò
kíkà|kíkà
kíkàn|kíkàn
kíkàwé|kíkàwé
kíká|kíká
kíkì|kíkì
kíkí|kíkí
kíkíní|kíkíní
kíkó|kíkó
kíkùn|kíkùn
kíkú|kíkú
kíkún|kíkún
kíkúnná|kíkúnná
kíkẹ̀|kíkɛ̀
kíkọ|kíkɔ
kíkọ̀|kíkɔ̀
kíkọ̀sílẹ̀|kíkɔ̀sílɛ̀
kíkọ́|kíkɔ́
kílàsì|kílàsì
kíláásì|kíláásì
kílódé|kílódé
kín|kín
kíndìnrín|kíndìnrín
kíni|kíni
kínkínní|kínkínní
kínla|kínla
kíní|kíní
kínǹiún|kínǹiún
kírun|kírũ
kítíkítí|kítíkítí
kíyèsi|kíjèsi
kíyèsára|kíjèsára
kíyèsí|kíjèsí
kíá|kíá
kíákíá|kíákíá
kíṣìnì|kíʃìnì
kí’fá|kí’fá
kò|kò
kòfowórọlá|kòfowórɔlá
kòfẹ́sọ̀|kòfɛ́sɔ̀
kòkò|kòkò
kòkòrò|kòkòrò
kòkó|kòkó
kòsémánìí|kòsémánìí
kòsókó|kòsókó
kòsọ́kọ́|kòsɔ́kɔ́
kòtò|kòtò
kòtún|kòtún
kòtẹ́milọ́rùn|kòtɛ́milɔ́rùn
kòó|kòó
kòńgẹ́|kòńɡɛ́
kó|kó
kóbáa|kóbáa
kódà|kódà
kójọ|kód͡ʒɔ
kójọpọ̀|kód͡ʒɔk͡pɔ̀
kókò|kókò
kókó|kókó
kókósẹ̀|kókósɛ̀
kólòbó|kólòbó
kóná|kóná
kóo|kóo
kópa|kók͡pa
kórajọ|kórad͡ʒɔ
kórira|kórira
kórè|kórè
kórìíra|kórìíra
kórílẹ̀|kórílɛ̀
kóró|kóró
kóò|kóò
kóórè|kóórè
kù|kù
kùkùté|kùkùté
kùmọ̀|kùmɔ̀
kùn|kùn
kùnà|kùnà
kùtù|kùtù
kùtùkùtù|kùtùkùtù
kùú|kùú
kú|kú
kúdí|kúdí
kúkú|kúkú
kúkúrú|kúkúrú
kún|kún
kúnkun|kúnkũ
kúnlé|kúnlé
kúnlẹ̀|kúnlɛ̀
kúnná|kúnná
kúrò|kúrò
kúrò’|kúrò’
kúrú|kúrú
kúùkàlẹ̀|kúùkàlɛ̀
kúúrù|kúúrù
kúṣẹ̀ẹ́|kúʃɛ̀ɛ́
kú’|kú’
kạ́n|kạ́n
kẹfà|kɛfà
kẹrinlelogun|kɛrĩleloɡũ
kẹrìndínlọ́gbọ̀n|kɛrìndínlɔ́ɡ͡bɔ̀n
kẹrìnlá|kɛrìnlá
kẹsànán|kɛsànán
kẹtalelogun|kɛtaleloɡũ
kẹtàdínlógbọ̀n|kɛtàdínlóɡ͡bɔ̀n
kẹtàdínlógójì|kɛtàdínlóɡód͡ʒì
kẹtàdínlógún|kɛtàdínlóɡún
kẹtàdínlọ́gbọ̀n|kɛtàdínlɔ́ɡ͡bɔ̀n
kẹtàlá|kɛtàlá
kẹtàlélógún|kɛtàlélóɡún
kẹwàá|kɛwàá
kẹwá|kɛwá
kẹ̀|kɛ̀
kẹ̀fà|kɛ̀fà
kẹ̀gbẹ́|kɛ̀ɡ͡bɛ́
kẹ̀jọ|kɛ̀d͡ʒɔ
kẹ̀kẹ́|kɛ̀kɛ́
kẹ̀rin|kɛ̀rĩ
kẹ̀rinlá|kɛ̀rĩlá
kẹ̀sàán|kɛ̀sàán
kẹ̀sán|kɛ̀sán
kẹ̀ta|kɛ̀ta
kẹ̀talá|kɛ̀talá
kẹ̀wá|kɛ̀wá
kẹ̀yìn|kɛ̀jìn
kẹ́|kɛ́
kẹ́dùn|kɛ́dùn
kẹ́gbẹ́|kɛ́ɡ͡bɛ́
kẹ́gàn|kɛ́ɡàn
kẹ́hìndé|kɛ́hìndé
kẹ́kọ̀ọ́|kɛ́kɔ̀ɔ́
kẹ́lẹ́|kɛ́lɛ́
kẹ́lẹ́kẹ́lẹ́|kɛ́lɛ́kɛ́lɛ́
kẹ́tù|kɛ́tù
kẹ́tẹ́kẹ́tẹ́|kɛ́tɛ́kɛ́tɛ́
kẹ́yìn|kɛ́jìn
kẹ́ẹ|kɛ́ɛ
kẹ́ẹ̀dógún|kɛ́ɛ̀dóɡún
kẹẹ́rìndílógún|kɛɛ́rìndílóɡún
kọ|kɔ
kọbi|kɔbi
kọjá|kɔd͡ʒá
kọjálọ|kɔd͡ʒálɔ
kọjú|kɔd͡ʒú
kọjúsọ́kọ|kɔd͡ʒúsɔ́kɔ
kọkanlelogun|kɔkanleloɡũ
kọkànlá|kɔkànlá
kọlu|kɔlu
kọlà|kɔlà
kọlù|kɔlù
kọminú|kɔmĩú
kọrin|kɔrĩ
kọrinti|kɔrĩti
kọsẹ̀|kɔsɛ̀
kọ̀|kɔ̀
kọ̀kan|kɔ̀kan
kọ̀kanlá|kɔ̀kanlá
kọ̀kànlélógún|kɔ̀kànlélóɡún
kọ̀lọ̀kọ̀lọ̀|kɔ̀lɔ̀kɔ̀lɔ̀
kọ̀nga|kɔ̀nɡa
kọ̀rọ̀|kɔ̀rɔ̀
kọ̀sílẹ̀|kɔ̀sílɛ̀
kọ̀tún|kɔ̀tún
kọ̀wé|kɔ̀wé
kọ̀ọ̀|kɔ̀ɔ̀
kọ̀ọ̀kan|kɔ̀ɔ̀kan
kọ̀ọ́|kɔ̀ɔ́
kọ́|kɔ́
kọ́bọ́ọ̀dù|kɔ́bɔ́ɔ̀dù
kọ́kànlá|kɔ́kànlá
kọ́kọ́|kɔ́kɔ́
kọ́kọ́rọ́|kɔ́kɔ́rɔ́
kọ́lá|kɔ́lá
kọ́ládé|kɔ́ládé
kọ́lápọ̀|kɔ́lák͡pɔ̀
kọ́lé|kɔ́lé
kọ́lémọ́lé|kɔ́lémɔ́lé
kọ́léṣùgbọ́n|kɔ́léʃùɡ͡bɔ́n
kọ́lẹ́|kɔ́lɛ́
kọ́lọ́fín|kɔ́lɔ́fín
kọ́ni|kɔ́ni
kọ́ni’|kɔ́ni’
kọ́núukọ́họ|kɔ́núukɔ́hɔ
kọ́ọ̀bù|kɔ́ɔ̀bù
kọ́ọ̀sì|kɔ́ɔ̀sì
kọ́ọ́pù|kɔ́ɔ́k͡pù
kọ́’|kɔ́’
kọ́’lé|kɔ́’lé
kọ́”|kɔ́”
kọọ́|kɔɔ́
kọ’sẹ̀|kɔ’sɛ̀
kọ’ṣẹ́|kɔ’ʃɛ́
k’àkànpọ̀|k’àkànk͡pɔ̀
k’áwa|k’áwa
k’éyàn|k’éjàn
k’óun|k’óũ
k’ọ́|k’ɔ́
l'omidan|l'omidan
l'ábàáwọlé|l'ábàáwɔlé
laadani|laadani
labani|labani
lada|lada
lahadi|lahadi
lahai|lahai
lahmi|lahmi
laiṣa|laiʃa
lakiṣi|lakiʃi
lakkumu|lakkumu
lama|lama
lameki|lameki
laodikea|laodikea
lasaru|lasaru
lasea|lasea
lati|lati
latin|latĩ
lawo|lawo
layé|lajé
laá|laá
le|le
lea|lea
leannoti|leannoti
lebanoni|lebanoni
lebo|lebo
leboati|leboati
lebona|lebona
lefi|lefi
leka|leka
lekki|lekki
lemueli|lemueli
lemọ́lemọ́|lemɔ́lemɔ́
lera|lera
letusi|letusi
leumiti|leumiti
libataini|libataĩi
libia|libia
libina|libĩa
libinati|libĩati
libni|libni
lida|lida
lidia|lidia
ligioni|liɡioni
likaonia|likaonia
likia|likia
linu|lĩu
lisania|lisania
lisia|lisia
lita|lita
litírésọ̀|litírésɔ̀
lo|lo
lodi|lodi
lojú|lod͡ʒú
lori|lori
lorí|lorí
lorúkọ|lorúkɔ
lotani|lotani
lowó|lowó
loyan|lojan
loúnjẹ|loúnd͡ʒɛ
lu|lu
ludi|ludi
luhiti|luhiti
lukiu|lukiu
luku|luku
lulẹ̀|lulɛ̀
lulẹ̀’|lulɛ̀’
lusi|lusi
lysra|ljsra
là|là
làjà|làd͡ʒà
làkàkà|làkàkà
lànà|lànà
làpálàpá|làk͡pálàk͡pá
làsàn|làsàn
làwa|làwa
làwọn|làwɔ̃
làá|làá
làágùn|làáɡùn
làálàá|làálàá
làǹtilanti|làǹtilanti
là’|là’
lá|lá
láago|láaɡo
lábàwọ́n|lábàwɔ́n
lábísí|lábísí
lábùkù|lábùkù
lábẹ́|lábɛ́
lábẹ́lẹ̀|lábɛ́lɛ̀
ládi|ládi
ládiípọ̀|ládiík͡pɔ̀
ládugbó|láduɡ͡bó
ládé|ládé
ládòkè|ládòkè
ládúru|ládúru
láfihàn|láfihàn
láfún|láfún
láfẹ́nwá|láfɛ́nwá
lágara|láɡara
lágara’|láɡara’
lágbedeméjì|láɡ͡bedeméd͡ʒì
lágbo|láɡ͡bo
lágbájá|láɡ͡bád͡ʒá
lágbára|láɡ͡bára
lájídé|lád͡ʒídé
lákoko|lákoko
lákokò|lákokò
lákòókò|lákòókò
lákòótan|lákòótan
lákọ̀ọ́kọ́|lákɔ̀ɔ́kɔ́
lálejò|láled͡ʒò
lálàá|lálàá
lálàáfíà|lálàáfíà
láláìyẹsẹ̀|láláìjɛsɛ̀
lálẹ́|lálɛ́
lána|lána
lánàá|lánàá
lápapọ̀|lák͡pak͡pɔ̀
lápákan|lák͡pákan
lára|lára
láradà|láradà
láradá|láradá
láre|láre
lárinrin|lárĩrĩ
lárugẹ|láruɡɛ
lárà|lárà
lásán|lásán
lásìkò|lásìkò
látara|látara
láti|láti
látijọ́|látid͡ʒɔ́
látàrí|látàrí
látàárọ̀|látàárɔ̀
látọwọ́|látɔwɔ́
lát’ẹ̀yìn|lát’ɛ̀jìn
láwùjọ|láwùd͡ʒɔ
láya|lája
láyà|lájà
láyè|lájè
láyé|lájé
láyò|lájò
láyọ̀|lájɔ̀
láàmú|láàmú
láàrín|láàrín
láàsí|láàsí
láàyè|láàjè
láàyò|láàjò
láààyè|láààjè
láààyè’|láààjè’
láàárín|láàárín
láàárọ̀|láàárɔ̀
láé|láé
láéláé|láéláé
láéláé’|láéláé’
láé’|láé’
láì|láì
láìbo|láìbo
láìbéèrè|láìbéèrè
láìbìkítà|láìbìkítà
láìbí|láìbí
láìbímọ|láìbímɔ
láìbẹ̀rù|láìbɛ̀rù
láìdúró|láìdúró
láìfi|láìfi
láìfèsì|láìfèsì
láìgba|láìɡ͡ba
láìjìyà|láìd͡ʒìjà
láìjẹ|láìd͡ʒɛ
láìjẹ̀bi|láìd͡ʒɛ̀bi
láìjẹ́|láìd͡ʒɛ́
láìka|láìka
láìká|láìká
láìkù|láìkù
láìlo|láìlo
láìlábàwọ́n|láìlábàwɔ́n
láìlábùkù|láìlábùkù
láìléwu|láìléwu
láìlófin|láìlófĩ
láìlẹ́gàn|láìlɛ́ɡàn
láìlọ́mọ|láìlɔ́mɔ
láìmọ̀|láìmɔ̀
láìmọ́|láìmɔ́
láìní|láìní
láìnídìí|láìnídìí
láìníye|láìníje
láìpẹ́|láìk͡pɛ́
láìpẹ́’|láìk͡pɛ́’
láìri|láìri
láìrí|láìrí
láìròtẹ́lẹ̀|láìròtɛ́lɛ̀
láìrọ|láìrɔ
láìsan|láìsan
láìsí|láìsí
láìsọ|láìsɔ
láìtún|láìtún
láìwádìí|láìwádìí
láìyí|láìjí
láìyẹ|láìjɛ
láìyẹsẹ̀|láìjɛsɛ̀
láìṣe|láìʃe
láìṣiyèméjì|láìʃijèméd͡ʒì
láìṣègbè|láìʃèɡ͡bè
láìṣẹ́ku|láìʃɛ́ku
láídé|láídé
láíláí|láíláí
láńtata|láńtata
láṣepé|láʃek͡pé
láṣẹ|láʃɛ
láṣọ|láʃɔ
lè|lè
lèkélèké|lèkélèké
lèmi|lèmi
lèyàn|lèjàn
lèyí|lèjí
lé|lé
lébi|lébi
léjìká|léd͡ʒìká
lékeléke|lékeléke
lékè|lékè
lélẹ̀|lélɛ̀
léni|léni
lénu|lénu
lénìí|lénìí
lépa|lék͡pa
léraléra|léraléra
lérán|lérán
lérè|lérè
lérí|lérí
lérò|lérò
léso|léso
lésì|lésì
létéńté|létéńté
létí|létí
létòlé|létòlé
létòlétò|létòlétò
léwe|léwe
léwu|léwu
léèrè|léèrè
léṣe|léʃe
lé‘lẹ̀|lé‘lɛ̀
lìgúísììkì|lìɡúísììkì
líle|líle
lílo|lílo
lílu|lílu
lílé|lílé
lílì|lílì
lílò|lílò
lílù|lílù
lílọ|lílɔ
lítíréṣọ|lítíréʃɔ
lítíréṣọ̀|lítíréʃɔ̀
lò|lò
lòdì|lòdì
lòpọ̀|lòk͡pɔ̀
lòun|lòũ
lòòṣà|lòòʃà
ló|ló
lóde|lóde
lódidi|lódidi
lódodo|lódodo
lódò|lódò
lófo|lófo
lógo|lóɡo
lógèdèǹgbé|lóɡèdèǹɡ͡bé
lógún|lóɡún
lóhunkóhun|lóhũkóhũ
lóhùn|lóhùn
lójijì|lód͡ʒid͡ʒì
lójoojúmọ́|lód͡ʒood͡ʒúmɔ́
lóju|lód͡ʒu
lójò|lód͡ʒò
lójú|lód͡ʒú
lójúkan|lód͡ʒúkan
lójúkojú|lód͡ʒúkod͡ʒú
lójúmọ́|lód͡ʒúmɔ́
lójúran|lód͡ʒúran
lójúu|lód͡ʒúu
lóko|lóko
lókè|lókè
lókèèrè|lókèèrè
lókùúta|lókùúta
lólè|lólè
lónìí|lónìí
lónìí’|lónìí’
lópin|lók͡pĩ
lópó|lók͡pó
lóri|lóri
lóru|lóru
lórí|lórí
lóríi|lóríi
lórílẹ̀|lórílɛ̀
lóríta|lóríta
lóríṣìíríṣìí|lóríʃìíríʃìí
lóró|lóró
lórúkọ|lórúkɔ
lósì|lósì
lótun|lótũ
lówelówe|lówelówe
lówurọ̀|lówurɔ̀
lówó|lówó
lówùúrọ̀|lówùúrɔ̀
lówúrọ̀|lówúrɔ̀
lóye|lóje
lóyún|lójún
lóòrèkóòrè|lóòrèkóòrè
lóòrùn|lóòrùn
lóòtítọ́|lóòtítɔ́
lóòótọ́|lóòótɔ́
lóókan|lóókan
lóǹkà|lóǹkà
lóṣù|lóʃù
lù|lù
lùú|lùú
lúgọ|lúɡɔ
lúwẹ̀ẹ́|lúwɛ̀ɛ́
lúúlúú|lúúlúú
lẹ|lɛ
lẹbẹ|lɛbɛ
lẹgbẹ̀rún|lɛɡ͡bɛ̀rún
lẹsẹ̀|lɛsɛ̀
lẹwá|lɛwá
lẹ̀|lɛ̀
lẹ́|lɛ́
lẹ́bi|lɛ́bi
lẹ́bàá|lɛ́bàá
lẹ́báa|lɛ́báa
lẹ́bùn|lɛ́bùn
lẹ́búlẹ́bú|lɛ́búlɛ́bú
lẹ́fun|lɛ́fũ
lẹ́gbe|lɛ́ɡ͡be
lẹ́gbẹ|lɛ́ɡ͡bɛ
lẹ́gbẹ̀|lɛ́ɡ͡bɛ̀
lẹ́gbẹ̀ẹ̀gbẹ́|lɛ́ɡ͡bɛ̀ɛ̀ɡ͡bɛ́
lẹ́gbẹ̀ẹ́|lɛ́ɡ͡bɛ̀ɛ́
lẹ́gbẹ́|lɛ́ɡ͡bɛ́
lẹ́hìn|lɛ́hìn
lẹ́jọ́|lɛ́d͡ʒɔ́
lẹ́kun|lɛ́kũ
lẹ́kùnrẹ́rẹ́|lɛ́kùnrɛ́rɛ́
lẹ́kún|lɛ́kún
lẹ́kọ̀ọ́|lɛ́kɔ̀ɔ́
lẹ́nu|lɛ́nu
lẹ́rìí|lɛ́rìí
lẹ́rù|lɛ́rù
lẹ́rú|lɛ́rú
lẹ́rẹ̀kẹ́|lɛ́rɛ̀kɛ́
lẹ́rọ̀|lɛ́rɔ̀
lẹ́san|lɛ́san
lẹ́sẹ|lɛ́sɛ
lẹ́sẹ̀|lɛ́sɛ̀
lẹ́sẹ̀kan|lɛ́sɛ̀kan
lẹ́sẹ̀kẹsẹ̀|lɛ́sɛ̀kɛsɛ̀
lẹ́sẹẹsẹ|lɛ́sɛɛsɛ
lẹ́sọ̀lẹ́sọ̀|lɛ́sɔ̀lɛ́sɔ̀
lẹ́tà|lɛ́tà
lẹ́tàn|lɛ́tàn
lẹ́tọ̀ọ́|lɛ́tɔ̀ɔ́
lẹ́wà|lɛ́wà
lẹ́yìn|lɛ́jìn
lẹ́yìnmatiu|lɛ́jìnmatiu
lẹ́yọ|lɛ́jɔ
lẹ́ṣẹ̀ẹ́|lɛ́ʃɛ̀ɛ́
lẹ́ẹ̀|lɛ́ɛ̀
lẹ́ẹ̀kan|lɛ́ɛ̀kan
lẹ́ẹ̀kansíi|lɛ́ɛ̀kansíi
lẹ́ẹ̀kejì|lɛ́ɛ̀ked͡ʒì
lẹ́ẹ̀kínní|lɛ́ɛ̀kínní
lẹ́ẹ̀méje|lɛ́ɛ̀méd͡ʒe
lẹ́ẹ̀méjì|lɛ́ɛ̀méd͡ʒì
lẹ́ẹ̀mẹta|lɛ́ɛ̀mɛta
lẹ́ẹ̀mẹ́ta|lɛ́ɛ̀mɛ́ta
lọ|lɔ
lọ'|lɔ'
lọkọ̀|lɔkɔ̀
lọlá|lɔlá
lọmọ|lɔmɔ
lọnítorí|lɔ̃ítorí
lọsí|lɔsí
lọti|lɔti
lọ̀|lɔ̀
lọ̀gá|lɔ̀ɡá
lọ̀nàa|lɔ̀nàa
lọ̀run|lɔ̀rũ
lọ̀rọ̀|lɔ̀rɔ̀
lọ̀sán|lɔ̀sán
lọ́|lɔ́
lọ́di|lɔ́di
lọ́dún|lɔ́dún
lọ́dọ̀|lɔ́dɔ̀
lọ́dọ́|lɔ́dɔ́
lọ́dọọdún|lɔ́dɔɔdún
lọ́fẹ̀ẹ́|lɔ́fɛ̀ɛ́
lọ́gbà|lɔ́ɡ͡bà
lọ́gbẹ́|lɔ́ɡ͡bɛ́
lọ́gbọọgba|lɔ́ɡ͡bɔɔɡ͡ba
lọ́gá|lɔ́ɡá
lọ́gán|lɔ́ɡán
lọ́hùn|lɔ́hùn
lọ́hùnnún|lɔ́hùnnún
lọ́jà|lɔ́d͡ʒà
lọ́jọjọ́|lɔ́d͡ʒɔd͡ʒɔ́
lọ́jọ̀|lɔ́d͡ʒɔ̀
lọ́jọ́|lɔ́d͡ʒɔ́
lọ́jọ́kọ́|lɔ́d͡ʒɔ́kɔ́
lọ́jọ́kọ́jọ́|lɔ́d͡ʒɔ́kɔ́d͡ʒɔ́
lọ́kàn|lɔ́kàn
lọ́kùnrin|lɔ́kùnrĩ
lọ́kọ|lɔ́kɔ
lọ́kọ̀|lɔ́kɔ̀
lọ́kọ̀ọ̀kan|lɔ́kɔ̀ɔ̀kan
lọ́la|lɔ́la
lọ́lá|lɔ́lá
lọ́mú|lɔ́mú
lọ́mọ|lɔ́mɔ
lọ́mọdé|lɔ́mɔdé
lọ́nà|lɔ́nà
lọ́nàkọnà|lɔ́nàkɔ̃à
lọ́pọlọ|lɔ́k͡pɔlɔ
lọ́pọ̀|lɔ́k͡pɔ̀
lọ́pọ̀lọpọ̀|lɔ́k͡pɔ̀lɔk͡pɔ̀
lọ́pọ̀lọ́pọ̀|lɔ́k͡pɔ̀lɔ́k͡pɔ̀
lọ́ra|lɔ́ra
lọ́run|lɔ́rũ
lọ́rùn|lɔ́rùn
lọ́rẹ|lɔ́rɛ
lọ́rọ̀|lɔ́rɔ̀
lọ́sàn|lɔ́sàn
lọ́sè|lɔ́sè
lọ́tun|lɔ́tũ
lọ́tí|lɔ́tí
lọ́tùn|lɔ́tùn
lọ́wọ|lɔ́wɔ
lọ́wọ́|lɔ́wɔ́
lọ́wọ́kí|lɔ́wɔ́kí
lọ́wọ́lọ́wọ́|lɔ́wɔ́lɔ́wɔ́
lọ́wọ́ọ́rọ́|lɔ́wɔ́ɔ́rɔ́
lọ́wọ́’|lɔ́wɔ́’
lọ́ṣẹ̀|lɔ́ʃɛ̀
lọ́ṣọ̀|lɔ́ʃɔ̀
lọ́ṣọ̀ọ́|lɔ́ʃɔ̀ɔ́
lọ́ọ́lọ́ọ́|lɔ́ɔ́lɔ́ɔ́
lọ’|lɔ’
l’|l’
l’orúkọ|l’orúkɔ
l’àgbà|l’àɡ͡bà
l’àrẹ̀mú|l’àrɛ̀mú
l’àwọn|l’àwɔ̃
l’àwọ́n|l’àwɔ́n
l’ágbo|l’áɡ͡bo
l’álejò|l’áled͡ʒò
l’ásìkò|l’ásìkò
l’átòkè|l’átòkè
l’átẹ|l’átɛ
l’áwùjọ|l’áwùd͡ʒɔ
l’áya|l’ája
l’áyé|l’ájé
l’ékò|l’ékò
l’ékòó|l’ékòó
l’éni|l’éni
l’énìí|l’énìí
l’ódèdè|l’ódèdè
l’óhùn|l’óhùn
l’ójú|l’ód͡ʒú
l’óru|l’óru
l’órí|l’órí
l’órílẹ̀|l’órílɛ̀
l’órúkọ|l’órúkɔ
l’ósì|l’ósì
l’óun|l’óũ
l’ówurọ̀|l’ówurɔ̀
l’ówó|l’ówó
l’óye|l’óje
l’ẹranko|l’ɛranko
l’ẹ́nu|l’ɛ́nu
l’ẹ́san|l’ɛ́san
l’ẹ́sẹ̀|l’ɛ́sɛ̀
l’ẹ́yin|l’ɛ́jĩ
l’ẹ́yìn|l’ɛ́jìn
l’ọlọ́run|l’ɔlɔ́rũ
l’ọmọ|l’ɔmɔ
l’ọ́dẹ̀dẹ̀|l’ɔ́dɛ̀dɛ̀
l’ọ́jà|l’ɔ́d͡ʒà
l’ọ́mú|l’ɔ́mú
l’ọ́san|l’ɔ́san
l’ọ́tùún|l’ɔ́tùún
l’ọ́wọ́|l’ɔ́wɔ́
m|m
ma|ma
maai|maai
maaka|maaka
maakati|maakati
maarati|maarati
maaseiah|maaseiah
maati|maati
magadani|maɡadani
magdalene|maɡdalene
magogu|maɡoɡu
magí|maɡí
maha|maha
mahalaleli|mahalaleli
mahalati|mahalati
mahane|mahane
mahila|mahila
mahili|mahili
makedonia|makedonia
makhelotu|makhelotu
makiri|makiri
makkeda|makkeda
makpela|makk͡pela
makọọsi|makɔɔsi
malikiṣua|malikiʃua
malkiah|malkiah
malkieli|malkieli
malluki|malluki
maloni|maloni
mamre|mamre
manaeni|manaeni
manaheti|manaheti
manase|manase
manchester|manchester
manna|manna
manoa|manoa
maoni|maoni
mara|mara
marala|marala
markaboti|markaboti
marku|marku
marta|marta
mary|marj
maskili|maskili
masreka|masreka
massa|massa
mattana|mattana
mattani|mattani
mattaniah|mattaniah
mattata|mattata
mattati|mattati
mattatia|mattatia
mattia|mattia
mattitiah|mattitiah
mecca|mecca
medadi|medadi
medeba|medeba
media|media
mefiboṣeti|mefiboʃeti
megido|meɡido
mehetabeeli|mehetabeeli
mehola|mehola
mehuni|mehũi
mejilelogoji|med͡ʒileloɡod͡ʒi
mela|mela
melatiah|melatiah
melea|melea
meliki|meliki
melkisedeki|melkisedeki
memfisi|memfisi
menahemu|menahemu
menna|menna
meonotai|meonotai
merabu|merabu
meraioti|meraioti
merari|merari
merataimu|merataimu
meraṣa|meraʃa
meremoti|meremoti
meriba|meriba
merodaki|merodaki
meronoti|meronoti
mesopotamia|mesok͡potamia
messia|messia
metusela|metusela
meèrírí|meèrírí
meṣa|meʃa
meṣaki|meʃaki
meṣeki|meʃeki
meṣesabeli|meʃesabeli
meṣullamu|meʃullamu
mi|mi
mibari|mibari
midiani|midiani
migdoli|miɡdoli
migida|miɡida
mika|mika
mikaeli|mikaeli
mikaiah|mikaiah
mikali|mikali
mikmasi|mikmasi
mikmeta|mikmeta
mikàn|mikàn
milalai|milalai
milefi|milefi
miletu|miletu
milka|milka
millo|millo
mina|mĩa
minini|mĩĩi
minti|mĩti
minítorí|mĩítorí
mioni|mioni
mira|mira
miriamu|miriamu
misia|misia
mispa|misk͡pa
misraimu|misraimu
miò|miò
miṣaeli|miʃaeli
miṣali|miʃali
miṣimana|miʃimana
miṣraiti|miʃraiti
mi’|mi’
mi’tí|mi’tí
mo|mo
moabu|moabu
modákẹ́kẹ́|modákɛ́kɛ́
mohammadu|mohammadu
mojí|mod͡ʒí
moleki|moleki
molidi|molidi
monisọ́lá|monisɔ́lá
monífádé|monífádé
mordekai|mordekai
more|more
moróunfólú|moróũfólú
moróunkẹ́|moróũkɛ́
mosa|mosa
mose|mose
mosenítorí|mosenítorí
moserotu|moserotu
motúnráyọ̀|motúnrájɔ̀
moyọ̀|mojɔ̀
mu|mu
muliberi|muliberi
mulẹ̀|mulɛ̀
munasoni|mũasoni
murá|murá
musitadi|musitadi
mutí|mutí
muṣi|muʃi
mu’|mu’
myrri|mjrri
mà|mà
màlú|màlú
màlúù|màlúù
màma|màma
màmá|màmá
màrìwò|màrìwò
màá|màá
màálù|màálù
má|má
máa|máa
májèlé|mád͡ʒèlé
májìyàgbé|mád͡ʒìjàɡ͡bé
májẹ̀mú|mád͡ʒɛ̀mú
márun|márũ
máràrùn|máràrùn
márààrún|márààrún
márùn|márùn
márùndínláàádọ́ta|márùndínláàádɔ́ta
márùndínlógójì|márùndínlóɡód͡ʒì
márùn’|márùn’
márùún|márùún
másítàsì|másítàsì
mátìíkú|mátìíkú
máíkẹ̀lì|máíkɛ̀lì
mèjì|mèd͡ʒì
mèremère|mèremère
mé|mé
méje|méd͡ʒe
méji|méd͡ʒi
méjèèje|méd͡ʒèèd͡ʒe
méjèèjì|méd͡ʒèèd͡ʒì
méjèèjìlá|méd͡ʒèèd͡ʒìlá
méjì|méd͡ʒì
méjìdínláàádọ́ta|méd͡ʒìdínláàádɔ́ta
méjìdínlógún|méd͡ʒìdínlóɡún
méjìdínlọ́gbọ̀n|méd͡ʒìdínlɔ́ɡ͡bɔ̀n
méjìlá|méd͡ʒìlá
méjìléláàádọ́rin|méd͡ʒìléláàádɔ́rĩ
méjìlélógójì|méd͡ʒìlélóɡód͡ʒì
méjìlélógún|méd͡ʒìlélóɡún
méjìlélọ́gọ́ta|méd͡ʒìlélɔ́ɡɔ́ta
méjì̀|méd͡ʒì̀
méjọ|méd͡ʒɔ
mélo|mélo
mélòó|mélòó
mélòómélòó|mélòómélòó
méèrírí|méèrírí
mẹ́rìnlélógóje|mɛ́rìnlélóɡód͡ʒe
mì|mì
mìíràn|mìíràn
mìíràn’|mìíràn’
mí|mí
mímu|mímu
mímì|mímì
mímí|mímí
mímú|mímú
mímúṣẹ|mímúʃɛ
mímọ|mímɔ
mímọ́|mímɔ́
mínísítà|mínísítà
míràn|míràn
mí’|mí’
mí”|mí”
mò|mò
mòjú|mòd͡ʒú
mòlẹ́bí|mòlɛ́bí
mòye|mòje
mó|mó
mójútó|mód͡ʒútó
mókun|mókũ
mórí|mórí
mótò|mótò
mùsùlùmí|mùsùlùmí
mú|mú
múlẹ̀|múlɛ̀
múmi|múmi
múná|múná
múnádóko|múnádóko
múra|múra
músá|músá
músẹ́|músɛ́
múu|múu
m̀bá|m̀bá
mẹlita|mɛlita
mẹ̀kúnnù|mɛ̀kúnnù
mẹ̀sàán|mɛ̀sàán
mẹ́|mɛ́
mẹ́fa|mɛ́fa
mẹ́fà|mɛ́fà
mẹ́fẹ̀ẹ̀fà|mɛ́fɛ̀ɛ̀fà
mẹ́jo|mɛ́d͡ʒo
mẹ́jọ|mɛ́d͡ʒɔ
mẹ́jọmẹ́jọ|mɛ́d͡ʒɔmɛ́d͡ʒɔ
mẹ́kà|mɛ́kà
mẹ́nu|mɛ́nu
mẹ́rin|mɛ́rĩ
mẹ́rìndínláàádọ́ta|mɛ́rìndínláàádɔ́ta
mẹ́rìndínlógún|mɛ́rìndínlóɡún
mẹ́rìnlá|mɛ́rìnlá
mẹ́rìnlélógún|mɛ́rìnlélóɡún
mẹ́rìnlélọ́gọ́rin|mɛ́rìnlélɔ́ɡɔ́rĩ
mẹ́rẹ̀ẹ̀rin|mɛ́rɛ̀ɛ̀rĩ
mẹ́rẹ̀ẹ̀rìnlá|mɛ́rɛ̀ɛ̀rìnlá
mẹ́san|mɛ́san
mẹ́sàn|mɛ́sàn
mẹ́ta|mɛ́ta
mẹ́ta’|mɛ́ta’
mẹ́tàdínlogun|mɛ́tàdínloɡũ
mẹ́tàdínlógún|mɛ́tàdínlóɡún
mẹ́tàlá|mɛ́tàlá
mẹ́tàlélógún|mɛ́tàlélóɡún
mẹ́tàlélọ́gbọ̀n|mɛ́tàlélɔ́ɡ͡bɔ̀n
mẹ́tẹ̀ẹ̀|mɛ́tɛ̀ɛ̀
mẹ́tẹ̀ẹ̀ta|mɛ́tɛ̀ɛ̀ta
mẹ́tẹ̀ẹ̀tàlá|mɛ́tɛ̀ɛ̀tàlá
mẹ́wa|mɛ́wa
mẹ́wàá|mɛ́wàá
mẹ́wàá’|mɛ́wàá’
mẹ́wẹ̀ẹ̀wá|mɛ́wɛ̀ɛ̀wá
mẹ́yìn|mɛ́jìn
mẹ́ẹ̀ẹ́dógún|mɛ́ɛ̀ɛ́dóɡún
mẹ́ẹ̀ẹ́dọ́gbọ̀n|mɛ́ɛ̀ɛ́dɔ́ɡ͡bɔ̀n
mọ|mɔ
mọdi|mɔdi
mọ̀|mɔ̀
mọ̀la|mɔ̀la
mọ̀lẹ́bí|mɔ̀lɛ́bí
mọ̀nà|mɔ̀nà
mọ̀nàmọ́ná|mɔ̀nàmɔ́ná
mọ̀rúfù|mɔ̀rúfù
mọ̀wé|mɔ̀wé
mọ̀ọ́|mɔ̀ɔ́
mọ́|mɔ́
mọ́in|mɔ́ĩ
mọ́jú|mɔ́d͡ʒú
mọ́kàndínlọ́gbọ̀n|mɔ́kàndínlɔ́ɡ͡bɔ̀n
mọ́kàndínlọ́gọ́rùn|mɔ́kàndínlɔ́ɡɔ́rùn
mọ́kànlá|mɔ́kànlá
mọ́lẹ̀|mɔ́lɛ̀
mọ́ni|mɔ́ni
mọ́nú|mɔ́nú
mọ́ra|mɔ́ra
mọ́rí|mɔ́rí
mọ́ríá|mɔ́ríá
mọ́sà|mɔ́sà
mọ́sálásí|mɔ́sálásí
mọ́tò|mɔ́tò
mọ́wọ́|mɔ́wɔ́
mọ́ṣáláṣí|mɔ́ʃáláʃí
mọ́ọ|mɔ́ɔ
mọ́’jú|mɔ́’d͡ʒú
mọ́’kọ̀|mɔ́’kɔ̀
m’ará|m’ará
m’ọ́jú|m’ɔ́d͡ʒú
n|n
n'ikú|n'ikú
na|na
naama|naama
naamani|naamani
naara|naara
naboti|naboti
nadabu|nadabu
nadi|nadi
nafiṣi|nafiʃi
naftali|naftali
nagai|naɡai
nahalali|nahalali
nahalieli|nahalieli
nahamu|nahamu
nahiṣoni|nahiʃoni
nahori|nahori
nahùn|nahùn
naili|naili
naini|naĩi
naomi|naomi
nara|nara
narani|narani
narkissu|narkissu
nasarene|nasarene
nasareti|nasareti
nasiri|nasiri
natanaeli|natanaeli
natani|natani
naumu|naumu
nawọ́|nawɔ́
naà|naà
nea|nea
neapoli|neak͡poli
nebaioti|nebaioti
nebati|nebati
nebo|nebo
nebukadnessari|nebukadnessari
nebusaradani|nebusaradani
nehalami|nehalami
nehemiah|nehemiah
neieli|neieli
nekebu|nekebu
neko|neko
nemueli|nemueli
nereu|nereu
neri|neri
neriah|neriah
nesia|nesia
netaneli|netaneli
netaniah|netaniah
netofa|netofa
ni|ni
nigeri|niɡeri
nigínnigín|niɡínniɡín
nikanoru|nikanoru
nikodemu|nikodemu
nikolasi|nikolasi
nikolatani|nikolatani
nikopoli|nikok͡poli
nikẹhìn|nikɛhìn
nimpa|nimk͡pa
nimra|nimra
nimṣi|nimʃi
ninefe|nĩefe
ninu|nĩu
nira|nira
niàti|niàti
ni’|ni’
njù|nd͡ʒù
nnkan|nnkan
noa|noa
nobu|nobu
nofa|nofa
noha|noha
nu|nu
nuni|nũi
nà|nà
nàgà|nàɡà
nàá|nàá
nàìjíríà|nàìd͡ʒíríà
ná|ná
náwó|náwó
náà|náà
náàpé|náàk͡pé
náà’|náà’
náání|náání
náírà|náírà
nì|nì
nìgbà|nìɡ͡bà
nìgéríà|nìɡéríà
nìgíríà|nìɡíríà
nìjíríà|nìd͡ʒíríà
nìkan|nìkan
nìwọ̀nyí|nìwɔ̀njí
nìyìí|nìjìí
nìyí|nìjí
nìyíwọ́n|nìjíwɔ́n
nìyẹn|nìjɛ̃
nì’|nì’
ní|ní
níbi|níbi
níbikíbi|níbikíbi
níbo|níbo
níbìkan|níbìkan
níbí|níbí
níbẹ̀|níbɛ̀
nídiìi|nídiìi
nídè|nídè
nídìí|nídìí
nífẹ|nífɛ
nífẹ̀ẹ́|nífɛ̀ɛ́
nífẹ́|nífɛ́
nífẹ́ẹ̀|nífɛ́ɛ̀
nígbà|níɡ͡bà
nígbàkígbà|níɡ͡bàkíɡ͡bà
nígbèkùn|níɡ͡bèkùn
nígb̀a|níɡ͡b̀a
nígbẹ̀yìn|níɡ͡bɛ̀jìn
níhà|níhà
níhìn|níhìn
níhòhò|níhòhò
níjanu|níd͡ʒanu
níjánu|níd͡ʒánu
níjọ́|níd͡ʒɔ́
níjọ́sí|níd͡ʒɔ́sí
níkẹ|níkɛ
níkẹyìn|níkɛjìn
níkọ̀kọ̀|níkɔ̀kɔ̀
nílà|nílà
níláárí|níláárí
nílé|nílé
nílò|nílò
nílùú|nílùú
nílú|nílú
nílẹ̀|nílɛ̀
nímù|nímù
nímọ̀ràn|nímɔ̀ràn
nína|nína
nínu|nínu
nínà|nínà
níná|níná
nínípọn|níník͡pɔ̃
nínú|nínú
nínú̀|nínú̀
nípa|ník͡pa
nípasẹ̀|ník͡pasɛ̀
nípá|ník͡pá
nípẹ̀kun|ník͡pɛ̀kũ
nípọn|ník͡pɔ̃
níran|níran
níràn|níràn
nírètí|nírètí
nírín|nírín
nírọ̀lẹ́|nírɔ̀lɛ́
nírọ́|nírɔ́
nísinsin|nísĩsĩ
nísàlẹ̀|nísàlɛ̀
nísìnsinyìí|nísìnsĩjìí
nísìyí|nísìjí
níta|níta
nítori|nítori
nítorí|nítorí
nítòsí|nítòsí
nítòótọ́|nítòótɔ́
níwájú|níwád͡ʒú
níwọ̀|níwɔ̀
níwọ̀n|níwɔ̀n
níwọ́|níwɔ́
níwọ́n|níwɔ́n
níwọ́ntúnwọ́nsì|níwɔ́ntúnwɔ́nsì
níye|níje
níyà|níjà
níyànjú|níjànd͡ʒú
níyàwó|níjàwó
níyì|níjì
níyẹ̀wù|níjɛ̀wù
níṣe|níʃe
níṣàlẹ̀|níʃàlɛ̀
níṣàájú|níʃàád͡ʒú
níṣẹ́|níʃɛ́
ní’|ní’
ní’bi|ní’bi
ní’bẹ̀|ní’bɛ̀
ní’fẹ|ní’fɛ
ní’fẹ̀ẹ́|ní’fɛ̀ɛ́
ní’fẹ̀ẹ́ẹ|ní’fɛ̀ɛ́ɛ
ní’fẹ́|ní’fɛ́
ní’jọ̀ọ́sí|ní’d͡ʒɔ̀ɔ́sí
ní’ka|ní’ka
ní’lu|ní’lu
ní’lé|ní’lé
ní’mú|ní’mú
ní’ta|ní’ta
ní’ṣẹ́|ní’ʃɛ́
ní”|ní”
nù|nù
nù’|nù’
nú|nú
nǹkan|nǹkan
nǹkankan|nǹkankan
nǹkan”|nǹkan”
nọ́mbà|nɔ́mbà
n’íbàdàn|n’íbàdàn
n’íbẹ̀|n’íbɛ̀
n’ífẹ|n’ífɛ
n’ílé|n’ílé
n’ílée|n’ílée
n’íwà|n’íwà
n’íyàwó|n’íjàwó
n’íṣẹ|n’íʃɛ
o|o
oba|oba
obadiah|obadiah
obedi|obedi
obotu|obotu
obì|obì
obìnrin|obìnrĩ
obìrin|obìrĩ
ode|ode
odi|odi
odidi|odidi
odindi|odĩdi
odì|odì
odò|odò
odó|odó
odùújókòó|odùúd͡ʒókòó
odún|odún
ofeli|ofeli
ofira|ofira
ofiri|ofiri
ogbó|oɡ͡bó
oge|oɡe
ogu|oɡu
ogun|oɡũ
ogunkógun|oɡũkóɡũ
ogunlọ́gọ̀|oɡũlɔ́ɡɔ̀
ogóje|oɡód͡ʒe
ogójì|oɡód͡ʒì
ogún|oɡún
ogúnlọ́gọ̀|oɡúnlɔ́ɡɔ̀
oholiabu|oholiabu
oholiba|oholiba
oholibama|oholibama
ohun|ohũ
ohunkóhun|ohũkóhũ
ohùn|ohùn
ojoojúmọ́|od͡ʒood͡ʒúmɔ́
ojì|od͡ʒì
ojíkutú|od͡ʒíkutú
ojú|od͡ʒú
ojúbọ|od͡ʒúbɔ
ojúkojú|od͡ʒúkod͡ʒú
ojúkòkòrò|od͡ʒúkòkòrò
ojúkójú|od͡ʒúkód͡ʒú
ojúlé|od͡ʒúlé
ojúlówó|od͡ʒúlówó
ojúlùmọ̀|od͡ʒúlùmɔ̀
ojúmọ́|od͡ʒúmɔ́
ojúmọ́’|od͡ʒúmɔ́’
ojúran|od͡ʒúran
ojúrere|od͡ʒúrere
ojúràn|od͡ʒúràn
ojúsàájú|od͡ʒúsàád͡ʒú
ojútikú|od͡ʒútikú
ojúṣe|od͡ʒúʃe
ojọ́|od͡ʒɔ́
okanri|okanri
oko|oko
oko’|oko’
okùn|okùn
okùnfà|okùnfà
okùnrin|okùnrĩ
olifi|olifi
olimpa|olimk͡pa
olorin|olorĩ
olorì|olorì
olámìdé|olámìdé
olè|olè
olódi|olódi
olódodo|olódodo
olódùmarè|olódùmarè
olódùmarè’|olódùmarè’
olódùmárè|olódùmárè
olófòófó|olófòófó
ológbe|olóɡ͡be
ológbò|olóɡ͡bò
ológo|olóɡo
ológoṣẹ́|olóɡoʃɛ́
ológun|olóɡũ
ológì|olóɡì
olóhùn|olóhùn
olójú|olód͡ʒú
olójúkòkòrò|olód͡ʒúkòkòrò
olójúméje|olód͡ʒúméd͡ʒe
olóko|olóko
olókè|olókè
olókìkí|olókìkí
olókùn|olókùn
olókùnkùn|olókùnkùn
olólùfẹ́|olólùfɛ́
olómi|olómi
olómìnira|olómìnira
olónìí|olónìí
olóore|olóore
olóorun|olóorũ
olópàá|olók͡pàá
olópò|olók͡pò
olórin|olórĩ
olórogún|olóroɡún
olórun|olórũ
olórí|olórí
olóró|olóró
olórúkọ|olórúkɔ
olówó|olówó
olówùú|olówùú
olóye|olóje
olóyè|olójè
olóyì|olójì
olóyún|olójún
olóògbé|olóòɡ͡bé
olóòtítọ́|olóòtítɔ́
olóòórùn|olóòórùn
olóòótọ́|olóòótɔ́
olóńgbò|olóńɡ͡bò
olóṣèlúu|olóʃèlúu
olùbojútó|olùbod͡ʒútó
olùbádámọ̀ràn|olùbádámɔ̀ràn
olùbáṣiṣẹ́|olùbáʃiʃɛ́
olùbùkún|olùbùkún
olùdarí|olùdarí
olùdáláre|olùdáláre
olùdámọ̀ràn|olùdámɔ̀ràn
olùdánwò|olùdánwò
olùdáǹdè|olùdáǹdè
olùdíje|olùdíd͡ʒe
olùfihàn|olùfihàn
olùfisùn|olùfisùn
olùfẹ́|olùfɛ́
olùfọkànsìn|olùfɔkànsìn
olùgbàlà|olùɡ͡bàlà
olùgbé|olùɡ͡bé
olùgbẹ̀san|olùɡ͡bɛ̀san
olùgbọ́|olùɡ͡bɔ́
olùgbọ́ran|olùɡ͡bɔ́ran
olùkórè|olùkórè
olùkọrin|olùkɔrĩ
olùkọsílẹ̀|olùkɔsílɛ̀
olùkọ́|olùkɔ́
olùkọ́ni|olùkɔ́ni
olùkọ́ọ|olùkɔ́ɔ
olùkọ́’|olùkɔ́’
olùmọ̀|olùmɔ̀
olùparun|olùk͡parũ
olùpilẹ̀ṣẹ̀|olùk͡pilɛ̀ʃɛ̀
olùpíngún|olùk͡pínɡún
olùpọ́njú|olùk͡pɔ́nd͡ʒú
olùrànlọ́wọ́|olùrànlɔ́wɔ́
olùrẹ́run|olùrɛ́rũ
olùsìn|olùsìn
olùsójú|olùsód͡ʒú
olùtùnú|olùtùnú
olùtọ́jú|olùtɔ́d͡ʒú
olùwa|olùwa
olùwòran|olùwòran
olùyàwòrán|olùjàwòrán
olùṣe|olùʃe
olùṣẹ̀san|olùʃɛ̀san
olùṣọ|olùʃɔ
olùṣọ́|olùʃɔ́
olùṣọ́gbà|olùʃɔ́ɡ͡bà
olùṣọ́gbá|olùʃɔ́ɡ͡bá
olùṣọ́nà|olùʃɔ́nà
olú|olú
olúborí|olúborí
olúkúlùkù|olúkúlùkù
olúmòye|olúmòje
olúmóyè|olúmójè
olúwa|olúwa
olúwatóbilọ́ba|olúwatóbilɔ́ba
olúwa’|olúwa’
olúwọlé|olúwɔlé
olọ́dọ̀|olɔ́dɔ̀
olọ́jọ́|olɔ́d͡ʒɔ́
omega|omeɡa
omeri|omeri
omi|omi
omijé|omid͡ʒé
omri|omri
omìmì|omìmì
omí|omí
omíró|omíró
omọ|omɔ
onani|onani
onesimu|onesimu
ono|ono
oní|oní
oníbàárà|oníbàárà
oníbárà|oníbárà
oníbèérè|oníbèérè
oníbùú|oníbùú
onídàájọ́|onídàád͡ʒɔ́
onídàájọ́’|onídàád͡ʒɔ́’
onídán|onídán
onídùúró|onídùúró
onígboyà|oníɡ͡bojà
onígbàgbọ́|oníɡ͡bàɡ͡bɔ́
onígbá|oníɡ͡bá
onígbèéraga|oníɡ͡bèéraɡa
onígbọ̀wọ́|oníɡ͡bɔ̀wɔ́
onígèlè|oníɡèlè
oníjà|oníd͡ʒà
oníjàgídíjàgan|oníd͡ʒàɡídíd͡ʒàɡan
oníjàngbàn|oníd͡ʒànɡ͡bàn
oníkálùkù|oníkálùkù
oníkúpani|oníkúk͡pani
oníkẹ̀kẹ́|oníkɛ̀kɛ́
onílà|onílà
onílàjà|onílàd͡ʒà
onílúlùkù|onílúlùkù
onílẹ̀|onílɛ̀
onílọ̀ra|onílɔ̀ra
onímájèlé|onímád͡ʒèlé
onímú|onímú
onímọ̀|onímɔ̀
onínú|onínú
onínúdídùn|onínúdídùn
onínúnibíni|onínúnibíni
onínúrere|onínúrere
onínútútù|onínútútù
onípàṣípàrọ̀|oník͡pàʃík͡pàrɔ̀
onípò|oník͡pò
onírin|onírĩ
onírun|onírũ
oníràwọ̀|oníràwɔ̀
oníròbìnújẹ́|oníròbìnúd͡ʒɛ́
onírúurú|onírúurú
onírẹsì|onírɛsì
onírẹ̀lẹ̀|onírɛ̀lɛ̀
onírọ́|onírɔ́
onísun|onísũ
onísòwò|onísòwò
onísùúrù|onísùúrù
onísọkúsọ|onísɔkúsɔ
onítara|onítara
onítótòtó|onítótòtó
onítúbú|onítúbú
onítẹ̀bọmi|onítɛ̀bɔmi
onítẹ̀lọ́rùn|onítɛ̀lɔ́rùn
onítọ̀hún|onítɔ̀hún
oníwà|oníwà
oníwàtítọ́|oníwàtítɔ́
oníwàásù|oníwàásù
oníye|oníje
oníyebíye|oníjebíje
oníyèméjì|oníjèméd͡ʒì
oníyọnu|oníjɔ̃u
oníyọ̀|oníjɔ̀
oníṣe|oníʃe
oníṣègùn|oníʃèɡùn
oníṣòwò|oníʃòwò
oníṣẹ̀|oníʃɛ̀
oníṣẹ́|oníʃɛ́
oníṣọ̀nà|oníʃɔ̀nà
oní’bèérè|oní’bèérè
ooju|ood͡ʒu
ooo|ooo
oore|oore
ooru|ooru
opó|ok͡pó
ore|ore
orebu|orebu
orin|orĩ
orogún|oroɡún
orun|orũ
orìṣà|orìʃà
orí|orí
orígun|oríɡũ
oríi|oríi
oríire|oríire
oríireè|oríireè
oríkèé|oríkèé
oríkì|oríkì
orílè|orílè
orílẹ̀|orílɛ̀
orísirísi|orísirísi
orísun|orísũ
orísìí|orísìí
orísìírísìí|orísìírísìí
oríta|oríta
oríṣi|oríʃi
oríṣiríṣi|oríʃiríʃi
oríṣìí|oríʃìí
oríṣìíríṣìí|oríʃìíríʃìí
orò|orò
oró|oró
orógbó|oróɡ͡bó
orúkọ|orúkɔ
orúnkún|orúnkún
oshòdì|oshòdì
osù|osù
osùn|osùn
otnieli|otnieli
otí|otí
owó|owó
owólabí|owólabí
owú|owú
oyin|ojĩ
oyè|ojè
oyìí|ojìí
oyín|ojín
oyíndà|ojíndà
oyún|ojún
oò|oò
oòduà|oòduà
oògùn|oòɡùn
oònì|oònì
oòrùn|oòrùn
oódo|oódo
oókan|oókan
oówo|oówo
oùn|oùn
oúnjẹ|oúnd͡ʒɛ
oǹdó|oǹdó
oṣhòdì|oʃhòdì
oṣooṣù|oʃooʃù
oṣó|oʃó
oṣù|oʃù
padani|k͡padani
padà|k͡padà
padé|k͡padé
pafosi|k͡pafosi
pagbo|k͡paɡ͡bo
pagieli|k͡paɡieli
pajẹ|k͡pad͡ʒɛ
pakà|k͡pakà
palali|k͡palali
pallu|k͡pallu
paltieli|k͡paltieli
paláradà|k͡paláradà
paláṣẹ|k͡paláʃɛ
palẹ̀|k͡palɛ̀
palẹ̀mọ́|k͡palɛ̀mɔ́
palọ́lọ́|k͡palɔ́lɔ́
pamfilia|k͡pamfilia
pami|k͡pami
pamílẹ́rin|k͡pamílɛ́rĩ
pamọ́|k͡pamɔ́
paná|k͡paná
panṣágà|k͡panʃáɡà
panṣágàọ̀kánjúwà|k͡panʃáɡàɔ̀kánd͡ʒúwà
panṣágà’|k͡panʃáɡà’
papọ̀|k͡pak͡pɔ̀
paradà|k͡paradà
paraku|k͡paraku
paramọ́lẹ̀|k͡paramɔ́lɛ̀
parani|k͡parani
parapọ̀|k͡parak͡pɔ̀
pargamu|k͡parɡamu
parimena|k͡parimena
parnaki|k͡parnaki
paroṣi|k͡paroʃi
parun|k͡parũ
parí|k͡parí
parẹ́|k͡parɛ́
parọ́|k͡parɔ́
parọ́rọ́|k͡parɔ́rɔ́
pasaki|k͡pasaki
pasea|k͡pasea
patara|k͡patara
patmo|k͡patmo
patroba|k͡patroba
paturosi|k͡paturosi
patí|k͡patí
paulu|k͡paulu
paulusi|k͡paulusi
paulu”|k͡paulu”
payá|k͡pajá
payínkeke|k͡pajínkeke
paá|k͡paá
pe|k͡pe
peali|k͡peali
pedaheli|k͡pedaheli
pedaiah|k͡pedaiah
pedasuri|k͡pedasuri
pegedé|k͡peɡedé
peka|k͡peka
pekahiah|k͡pekahiah
pekodi|k͡pekodi
pelegi|k͡peleɡi
peleti|k͡peleti
peloni|k͡peloni
peléke|k͡peléke
peni|k͡peni
pentikosti|k͡pentikosti
penueli|k͡penueli
peori|k͡peori
peresi|k͡peresi
perga|k͡perɡa
perli|k͡perli
persi|k͡persi
persia|k͡persia
petahiah|k͡petahiah
peteru|k͡peteru
peteru”|k͡peteru”
petori|k͡petori
pi|k͡pi
pilatu|k͡pilatu
pileeni|k͡pileeni
pileseri|k͡pileseri
pinpin|k͡pĩk͡pĩ
pinu|k͡pĩu
piramu|k͡piramu
piratoni|k͡piratoni
pirusi|k͡pirusi
pisidia|k͡pisidia
po|k͡po
pohùnréré|k͡pohùnréré
pokúlúrúmuṣu|k͡pokúlúrúmuʃu
polongo|k͡polonɡo
polukisu|k͡polukisu
polówó|k͡polówó
polúkúrúmuṣu|k͡polúkúrúmuʃu
pomegiranate|k͡pomeɡiranate
poníṣègùn|k͡poníʃèɡùn
poplari|k͡pok͡plari
potifari|k͡potifari
potifẹra|k͡potifɛra
pretoriomu|k͡pretoriomu
priskilla|k͡priskilla
prokoru|k͡prokoru
pubiliu|k͡pubiliu
pudeni|k͡pudeni
pufa|k͡pufa
punoni|k͡pũoni
pupa|k͡puk͡pa
purimu|k͡purimu
purọ́|k͡purɔ́
puteoli|k͡puteoli
puti|k͡puti
pàdánù|k͡pàdánù
pàdé|k͡pàdé
pàgọ́|k͡pàɡɔ́
pàkòpàkò|k͡pàkòk͡pàkò
pàlàpálá|k͡pàlàk͡pálá
pànìyàn|k͡pànìjàn
pàpà|k͡pàk͡pà
pàrọ̀|k͡pàrɔ̀
pàtàkì|k͡pàtàkì
pàtàkí|k͡pàtàkí
pàtẹ́wọ́|k͡pàtɛ́wɔ́
pààlà|k͡pààlà
pààrọ̀|k͡pààrɔ̀
pààyàn|k͡pààjàn
pàápàá|k͡pàák͡pàá
pàǹtí|k͡pàǹtí
pàṣán|k͡pàʃán
pàṣípàrọ̀|k͡pàʃík͡pàrɔ̀
pàṣẹ|k͡pàʃɛ
pà’nìyàn|k͡pà’nìjàn
pá|k͡pá
páa|k͡páa
pákó|k͡pákó
pángolo|k͡pánɡolo
pápá|k͡pák͡pá
párá|k͡párá
pátá|k͡pátá
pátákò|k͡pátákò
pátákó|k͡pátákó
pátápátá|k͡páták͡pátá
páyà|k͡pájà
páànù|k͡páànù
pè|k͡pè
pèsè|k͡pèsè
pète|k͡pète
pèé|k͡pèé
pè’run|k͡pè’rũ
pé|k͡pé
péeruku|k͡péeruku
péjú|k͡péd͡ʒú
péjọ|k͡péd͡ʒɔ
péjọpọ̀|k͡péd͡ʒɔk͡pɔ̀
pélébé|k͡pélébé
pépé|k͡pék͡pé
péré|k͡péré
péèmi|k͡péèmi
pìrìgìdì|k͡pìrìɡìdì
pìtàn|k͡pìtàn
pín|k͡pín
pínpín|k͡pínk͡pín
pínyà|k͡pínjà
pípa|k͡pík͡pa
pípadà|k͡pík͡padà
píparun|k͡pík͡parũ
píparẹ́|k͡pík͡parɛ́
pípe|k͡pík͡pe
pípàṣẹ|k͡pík͡pàʃɛ
pípá|k͡pík͡pá
pípèsè|k͡pík͡pèsè
pípé|k͡pík͡pé
pípẹ́|k͡pík͡pɛ́
pípọ́n|k͡pík͡pɔ́n
pò|k͡pò
pòjù|k͡pòd͡ʒù
pòkìkí|k͡pòkìkí
pòruurù|k͡pòruurù
pòwe|k͡pòwe
pòórá|k͡pòórá
pòǹgbẹ|k͡pòǹɡ͡bɛ
pópó|k͡pók͡pó
pópóọlá|k͡pók͡póɔlá
pósí|k͡pósí
póun|k͡póũ
púpò|k͡púk͡pò
púpọ̀|k͡púk͡pɔ̀
púpọ̀púpọ̀|k͡púk͡pɔ̀k͡púk͡pɔ̀
púpọ́|k͡púk͡pɔ́
pẹja|k͡pɛd͡ʒa
pẹrẹsẹ|k͡pɛrɛsɛ
pẹ̀gàn|k͡pɛ̀ɡàn
pẹ̀ka|k͡pɛ̀ka
pẹ̀lú|k͡pɛ̀lú
pẹ̀lúmi|k͡pɛ̀lúmi
pẹ̀lúpẹ̀lú|k͡pɛ̀lúk͡pɛ̀lú
pẹ̀lú’|k͡pɛ̀lú’
pẹ̀lú”|k͡pɛ̀lú”
pẹ̀lẹ́|k͡pɛ̀lɛ́
pẹ̀lẹ́pẹ̀lẹ́|k͡pɛ̀lɛ́k͡pɛ̀lɛ́
pẹ̀tù|k͡pɛ̀tù
pẹ̀tẹ̀pẹ́tẹ̀|k͡pɛ̀tɛ̀k͡pɛ́tɛ̀
pẹ̀tẹ́lẹ̀|k͡pɛ̀tɛ́lɛ̀
pẹ̀yìndà|k͡pɛ̀jìndà
pẹ́|k͡pɛ́
pẹ́ja|k͡pɛ́d͡ʒa
pẹ́kípẹ́kí|k͡pɛ́kík͡pɛ́kí
pẹ́pẹ́|k͡pɛ́k͡pɛ́
pẹ́pẹ́yẹ|k͡pɛ́k͡pɛ́jɛ
pẹ́rẹpẹ̀rẹ|k͡pɛ́rɛk͡pɛ̀rɛ
pẹẹrẹ|k͡pɛɛrɛ
pọ|k͡pɔ
pọntiu|k͡pɔ̃tiu
pọntu|k͡pɔ̃tu
pọtí|k͡pɔtí
pọ̀|k͡pɔ̀
pọ̀jù|k͡pɔ̀d͡ʒù
pọ̀n|k͡pɔ̀n
pọ́n|k͡pɔ́n
pọ́ọ̀lù|k͡pɔ́ɔ̀lù
p’abírì|k͡p’abírì
p’abírí|k͡p’abírí
p’ọmi|k͡p’ɔmi
p’ọmọ|k͡p’ɔmɔ
rabba|rabba
rabbi|rabbi
rabboni|rabboni
rafa|rafa
rahabu|rahabu
rahamu|rahamu
rakeli|rakeli
rama|rama
ramesesi|ramesesi
ramoti|ramoti
ramu|ramu
ramúramù|ramúramù
ran|ran
ranjú|rand͡ʒú
ranni|ranni
rawọ́|rawɔ́
raàrẹ|raàrɛ
reaiah|reaiah
reba|reba
rebeka|rebeka
refaimu|refaimu
refani|refani
refidimu|refidimu
regiomu|reɡiomu
rehabiah|rehabiah
rehoboamu|rehoboamu
rehobu|rehobu
rehumu|rehumu
rejú|red͡ʒú
rekabu|rekabu
rekemu|rekemu
remaliah|remaliah
rere|rere
rere’|rere’
resa|resa
resini|resĩi
retí|retí
reu|reu
reubeni|reubeni
reueli|reueli
reṣefu|reʃefu
ribai|ribai
ribiribi|ribiribi
ribla|ribla
rimoni|rimoni
rin|rĩ
rinlẹ̀|rĩlɛ̀
rispa|risk͡pa
ri’ra|ri’ra
roda|roda
rodo|rodo
rodu|rodu
rogeli|roɡeli
rogelimu|roɡelimu
roi|roi
rojọ́|rod͡ʒɔ́
rokoṣo|rokoʃo
rokà|rokà
romu|romu
ronú|ronú
ronúpìwàdà|ronúk͡pìwàdà
ronúpìwàdà’|ronúk͡pìwàdà’
rora|rora
rorò|rorò
ro’kà|ro’kà
ru|ru
rudi|rudi
rufusi|rufusi
ruhama|ruhama
run|rũ
rungbẹ́|rũɡ͡bɛ́
rutu|rutu
rwanda|rwanda
rà|rà
ràbàtà|ràbàtà
ràgà|ràɡà
ràkunmí|ràkũmí
ràn|ràn
ràndànràndàn|ràndànràndàn
rànwú|rànwú
ràṣídì|ràʃídì
rádaràda|rádaràda
rájí|rád͡ʒí
rákò|rákò
rán|rán
ránsẹ́|ránsɛ́
rántí|rántí
ránṣẹ́|ránʃɛ́
rárá|rárá
ráyè|rájè
ráàyè|ráàjè
rè|rè
rèé|rèé
ré|ré
rékọjá|rékɔd͡ʒá
réré|réré
réré’|réré’
rì|rì
rìkíṣí|rìkíʃí
rìn|rìn
rìnde|rìnde
rìnriǹ|rìnrĩ̀
rìnrìn|rìnrìn
rìn’|rìn’
rìn’de|rìn’de
rí|rí
rídìí|rídìí
ríi|ríi
rín|rín
rínrín|rínrín
ríra|ríra
ríran|ríran
ríre|ríre
ríru|ríru
rírun|rírũ
rírà|rírà
rírán|rírán
rírántí|rírántí
rírì|rírì
rírìn|rírìn
rírò|rírò
rírù|rírù
rírùn|rírùn
rírú|rírú
rírúbọ|rírúbɔ
rírẹ́|rírɛ́
rírọ|rírɔ
rírọ̀|rírɔ̀
ríṣẹ́|ríʃɛ́
rí’|rí’
rí’ṣẹ́|rí’ʃɛ́
rò|rò
rògbòdìyàn|ròɡ͡bòdìjàn
ròhìn|ròhìn
ròyìn|ròjìn
ró|ró
róbótó|róbótó
rówó|rówó
rù|rù
rùn|rùn
rú|rú
rúbọ|rúbɔ
rúdurùdu|rúdurùdu
rúdí|rúdí
rúkèrúdò|rúkèrúdò
rún|rún
rúwé|rúwé
rẹ|rɛ
rẹlẹ̀|rɛlɛ̀
rẹpẹtẹ|rɛk͡pɛtɛ
rẹra|rɛra
rẹrẹ|rɛrɛ
rẹwà|rɛwà
rẹ̀|rɛ̀
rẹ̀bi|rɛ̀bi
rẹ̀dẹ̀rẹ̀dẹ̀|rɛ̀dɛ̀rɛ̀dɛ̀
rẹ̀wẹ̀sì|rɛ̀wɛ̀sì
rẹ̀yìn|rɛ̀jìn
rẹ̀ó|rɛ̀ó
rẹ̀ṣùgbọ́n|rɛ̀ʃùɡ͡bɔ́n
rẹ̀ẹ́|rɛ̀ɛ́
rẹ̀’|rɛ̀’
rẹ́|rɛ́
rẹ́dẹ́rẹ́dẹ́|rɛ́dɛ́rɛ́dɛ́
rẹ́rin|rɛ́rĩ
rẹ́run|rɛ́rũ
rẹ́rìn|rɛ́rìn
rẹ́rìín|rɛ́rìín
rẹ́yìn|rɛ́jìn
rẹ’|rɛ’
rọbí|rɔbí
rọkọ|rɔkɔ
rọlẹ̀|rɔlɛ̀
rọrùn|rɔrùn
rọ̀|rɔ̀
rọ̀gbà|rɔ̀ɡ͡bà
rọ̀gbọ̀kú|rɔ̀ɡ͡bɔ̀kú
rọ̀gún|rɔ̀ɡún
rọ̀jò|rɔ̀d͡ʒò
rọ̀ọ́|rɔ̀ɔ́
rọ́|rɔ́
rọ́jú|rɔ́d͡ʒú
rọ́pò|rɔ́k͡pò
rọ́rọ́|rɔ́rɔ́
r’oko|r’oko
r’ógun|r’óɡũ
r’órí|r’órí
s'ọ́jà|s'ɔ́d͡ʒà
sa|sa
saamu|saamu
saananimu|saananimu
sabadi|sabadi
sabakitani|sabakitani
sadoku|sadoku
sadusi|sadusi
safire|safire
safironi|safironi
safiru|safiru
safu|safu
sahaduta|sahaduta
sahẹndiri|sahɛ̃diri
saipurọsi|saik͡purɔsi
sakeu|sakeu
sakkuri|sakkuri
salafi|salafi
salami|salami
saleka|saleka
salimu|salimu
salma|salma
salmona|salmona
salmoni|salmoni
salmunna|salmũna
salome|salome
salẹmu|salɛmu
samaria|samaria
samla|samla
samosi|samosi
samotrakea|samotrakea
samsoni|samsoni
samuẹli|samuɛli
san|san
sanballati|sanballati
sanjọ́|sand͡ʒɔ́
sanoa|sanoa
sanra|sanra
sanwó|sanwó
sara|sara
sarai|sarai
sardi|sardi
sarefati|sarefati
saretani|saretani
saridi|saridi
saulu|saulu
sealoti|sealoti
seba|seba
sebadiah|sebadiah
sebede|sebede
sebi|sebi
seboimu|seboimu
sebuluni|sebulũi
sedeki|sedeki
sedekiah|sedekiah
sefaniah|sefaniah
sefaredi|sefaredi
sefarfaimi|sefarfaimi
sefari|sefari
sefoni|sefoni
segiu|seɡiu
segubu|seɡubu
seiri|seiri
sekariah|sekariah
sekundu|sekũdu
sela|sela
seledi|seledi
seleusia|seleusia
selofehadi|selofehadi
semaraimu|semaraimu
semari|semari
senaa|senaa
senasi|senasi
sennakeribu|sennakeribu
sera|sera
serah|serah
seraiah|seraiah
sereda|sereda
seredi|seredi
sereṣi|sereʃi
serua|serua
serubbabeli|serubbabeli
serugu|seruɡu
seruiah|seruiah
setamu|setamu
seti|seti
seusi|seusi
shèyí|shèjí
shíttù|shíttù
sibekai|sibekai
sibeoni|sibeoni
sibma|sibma
sibraimu|sibraimu
siddimu|siddimu
sidoni|sidoni
siene|siene
sifi|sifi
sihoni|sihoni
sikamine|sikamĩe
sikamore|sikamore
sikari|sikari
siklagi|siklaɡi
sikri|sikri
sikẹfa|sikɛfa
sila|sila
siletai|siletai
silfanu|silfanu
silihi|silihi
silipa|silik͡pa
siloamu|siloamu
simeoni|simeoni
simi|simi
similólúwa|similólúwa
simisọ́lá|simisɔ́lá
simoni|simoni
simri|simri
simí|simí
sin|sĩ
sinagọgu|sĩaɡɔɡu
sinah|sĩah
sinai|sĩai
sini|sĩi
sinmi|sĩmi
sintike|sĩtike
sinu|sĩu
sioni|sioni
sipai|sik͡pai
sippori|sik͡pk͡pori
sirakusi|sirakusi
siro|siro
sisera|sisera
sisí|sisí
si’lé|si’lé
skitia|skitia
slessor|slessor
smirna|smirna
snap|snak͡p
so|so
soari|soari
soba|soba
sobaki|sobaki
sodomu|sodomu
sofari|sofari
sohari|sohari
soko|soko
solomoni|solomoni
sopateru|sok͡pateru
sora|sora
sorati|sorati
soreki|soreki
sosipateru|sosik͡pateru
sostene|sostene
spania|sk͡pania
staki|staki
stefana|stefana
stefanu|stefanu
stoiki|stoiki
suari|suari
sukkoti|sukkoti
sulfuru|sulfuru
sun|sũ
sunwọ̀n|sũwɔ̀n
suri|suri
suriṣaddai|suriʃaddai
surulere|surulere
susa|susa
susana|susana
susimu|susimu
suwọ̀n|suwɔ̀n
sàdáńkátà|sàdáńkátà
sàfúrátù|sàfúrátù
sàkánì|sàkánì
sàkání|sàkání
sàlàyé|sàlàjé
sàlámì|sàlámì
sàláwà|sàláwà
sàmì|sàmì
sàmù|sàmù
sàn|sàn
sànúsí|sànúsí
sàràkí|sàràkí
sàráà|sàráà
sàtakò|sàtakò
sàágámù|sàáɡámù
sàárè|sàárè
sàáré|sàáré
sá|sá
sába|sába
sábà|sábà
sábẹ́|sábɛ́
sáfẹ́jọ́|sáfɛ́d͡ʒɔ́
sákárà|sákárà
sákí|sákí
sálà|sálà
sálúbàtà|sálúbàtà
sálọ|sálɔ
sán|sán
sánmọ̀|sánmɔ̀
sápá|sák͡pá
sára|sára
sáré|sáré
sátidé|sátidé
sáwo|sáwo
sáyé|sájé
sáyídì|sájídì
sáyẹ́ǹsì|sájɛ́ǹsì
sáà|sáà
sáàgámù|sáàɡámù
sáàpá|sáàk͡pá
sáàrín|sáàrín
sáàárín|sáàárín
sáńsán|sáńsán
sè|sè
sé|sé
sébọ́|sébɔ́
séwu|séwu
sì|sì
sìlàmíyà|sìlàmíjà
sìn|sìn
sìnkú|sìnkú
sìnyí|sìnjí
sìn’|sìn’
sí|sí
síbi|síbi
síbikíbi|síbikíbi
síbí|síbí
síbẹ̀|síbɛ̀
síbẹ̀síbẹ̀|síbɛ̀síbɛ̀
síbẹ̀’|síbɛ̀’
síh|síh
síhà|síhà
síi|síi
síji|síd͡ʒi
síjú|síd͡ʒú
sílè|sílè
sílé|sílé
sílẹ̀|sílɛ̀
sílẹ̀ẹ́lẹ̀|sílɛ̀ɛ́lɛ̀
sílẹ̀’|sílɛ̀’
sílẹ́|sílɛ́
símbálì|símbálì
símisọ́lá|símisɔ́lá
sín|sín
sínsin|sínsĩ
sínu|sínu
sínwín|sínwín
sínígbà|síníɡ͡bà
sínú|sínú
sínúu'gbó|sínúu'ɡ͡bó
sípa|sík͡pa
sípò|sík͡pò
sírú|sírú
sísan|sísan
sísanra|sísanra
sísun|sísũ
sísá|sísá
sísán|sísán
sísáré|sísáré
sísè|sísè
sísùn|sísùn
sísún|sísún
sísọ|sísɔ
síta|síta
sítẹ́là|sítɛ́là
síwá|síwá
síwájú|síwád͡ʒú
síyìn|síjìn
síírí|síírí
sí’|sí’
sí’bi|sí’bi
sí’lẹ̀|sí’lɛ̀
sí’pò|sí’k͡pò
sòdì|sòdì
só|só
sóde|sóde
sódò|sódò
sójú|sód͡ʒú
sóko|sóko
sókè|sókè
sókè’|sókè’
sórí|sórí
sósì|sósì
sùlíyá|sùlíjá
sùn|sùn
sùwíìtì|sùwíìtì
sùúrù|sùúrù
sùúrùlérè|sùúrùlérè
sú|sú
súfe|súfe
sún|sún
súnkún|súnkún
súnkẹrẹ|súnkɛrɛ
súnmọ́|súnmɔ́
súre|súre
súré|súré
súu|súu
súyà|sújà
sẹ|sɛ
sẹlòmíràn|sɛlòmíràn
sẹlẹ̀|sɛlɛ̀
sẹ̀|sɛ̀
sẹ̀san|sɛ̀san
sẹ́|sɛ́
sẹ́gbẹ̀|sɛ́ɡ͡bɛ̀
sẹ́nu|sɛ́nu
sẹ́nìkan|sɛ́nìkan
sẹ́nígà|sɛ́níɡà
sẹ́yìn|sɛ́jìn
sọ|sɔ
sọdá|sɔdá
sọfà|sɔfà
sọjí|sɔd͡ʒí
sọkún|sɔkún
sọkún’|sɔkún’
sọlá|sɔlá
sọlẹ̀|sɔlɛ̀
sọni|sɔ̃i
sọnù|sɔ̃ù
sọnù’|sɔ̃ù’
sọtẹ́lẹ̀|sɔtɛ́lɛ̀
sọ̀|sɔ̀
sọ̀dí|sɔ̀dí
sọ̀kalẹ̀|sɔ̀kalɛ̀
sọ̀kò|sɔ̀kò
sọ̀rọ̀|sɔ̀rɔ̀
sọ̀rọ̀sọ̀rọ̀|sɔ̀rɔ̀sɔ̀rɔ̀
sọ́dọ̀|sɔ́dɔ̀
sọ́hùn|sɔ́hùn
sọ́kàn|sɔ́kàn
sọ́nà|sɔ́nà
sọ́rọ̀|sɔ́rɔ̀
sọ́tùn|sɔ́tùn
sọ́tọ̀|sɔ́tɔ̀
sọ́un|sɔ́ũ
sọ́wọ́|sɔ́wɔ́
sọ’|sɔ’
s’ayé|s’ajé
s’ohun|s’ohũ
s’olóògbé|s’olóòɡ͡bé
s’àmín|s’àmín
s’ágbèrè|s’áɡ͡bèrè
s’áré|s’áré
s’ásán|s’ásán
s’éjìgbò|s’éd͡ʒìɡ͡bò
s’ójú|s’ód͡ʒú
s’ójúu|s’ód͡ʒúu
s’órí|s’órí
s’ẹ́dẹ|s’ɛ́dɛ
s’ẹ́ni|s’ɛ́ni
s’ẹ́nikẹ́ni|s’ɛ́nikɛ́ni
s’ẹ́nu|s’ɛ́nu
s’ẹ́yìn|s’ɛ́jìn
s’ọmọ|s’ɔmɔ
s’ọ́dọ̀|s’ɔ́dɔ̀
s’ọ́run|s’ɔ́rũ
s’ọ́yọ̀|s’ɔ́jɔ̀
taanaki|taanaki
taanati|taanati
tabanaku|tabanaku
tabita|tabita
tabo|tabo
tabori|tabori
tabrimoni|tabrimoni
tafeti|tafeti
tafàtafà|tafàtafà
tage|taɡe
tahani|tahani
tahati|tahati
tajà|tad͡ʒà
tají|tad͡ʒí
tako|tako
takuntakun|takũtakũ
takété|takété
takò|takò
takú|takú
takọ|takɔ
talita|talita
talmai|talmai
tamari|tamari
tamariski|tamariski
tambori|tambori
tami|tami
tamusi|tamusi
tamẹ́dùn|tamɛ́dùn
tan|tan
tanhumeti|tanhumeti
tani|tani
tanijẹ|tanid͡ʒɛ
tannijẹ|tannid͡ʒɛ
tanná|tanná
tanù|tanù
tapenesi|tak͡penesi
tara|tara
tarsu|tarsu
tarṣiṣi|tarʃiʃi
tata|tata
tatimi|tatimi
tayò|tajò
tayọ|tajɔ
tayọ̀|tajɔ̀
tayọ̀tayọ̀|tajɔ̀tajɔ̀
tekoa|tekoa
teli|teli
tema|tema
temani|temani
teofilu|teofilu
tereṣi|tereʃi
tertiu|tertiu
tertulu|tertulu
tete|tete
tetrarki|tetrarki
teuda|teuda
tiatira|tiatira
tiberia|tiberia
tiberiu|tiberiu
tifisa|tifisa
tigbòǹgbò|tiɡ͡bòǹɡ͡bò
tiglat|tiɡlat
tiiri|tiiri
tijú|tid͡ʒú
tikfa|tikfa
tikiku|tikiku
tikuosi|tikuosi
tilé|tilé
tilétilé|tilétilé
tilẹ̀|tilɛ̀
timna|timna
timnati|timnati
timoni|timoni
timotiu|timotiu
tiná|tĩá
tinú|tĩú
tinúadé|tĩúadé
tinúbu|tĩúbu
tinúbú|tĩúbú
tinútinú|tĩútĩú
tipa|tik͡pa
tipasẹ̀|tik͡pasɛ̀
tipá|tik͡pá
tipátipá|tik͡pátik͡pá
tipẹ́tipẹ́|tik͡pɛ́tik͡pɛ́
tirannusi|tirannusi
tire|tire
tirofimu|tirofimu
tirsa|tirsa
tirẹ̀|tirɛ̀
titu|titu
titó|titó
titẹ̀|titɛ̀
tiwa|tiwa
tiwaladé|tiwaladé
tiwatọ́pẹ́|tiwatɔ́k͡pɛ́
tiwa’|tiwa’
tiwátọ́pẹ́|tiwátɔ́k͡pɛ́
tiwọn|tiwɔ̃
tiyín|tijín
tií|tií
tiṣibi|tiʃibi
tiẹ̀|tiɛ̀
to|to
tobiah|tobiah
tobìnrin|tobìnrĩ
tofeti|tofeti
togarma|toɡarma
tojú|tod͡ʒú
tokhati|tokhati
tola|tola
tolúwa|tolúwa
tomasi|tomasi
topasi|tok͡pasi
torí|torí
trakoniti|trakoniti
trifena|trifena
trifosa|trifosa
troasi|troasi
tu|tu
tubali|tubali
tulẹ̀|tulɛ̀
tumimu|tumimu
tun|tũ
tuntun|tũtũ
tutù|tutù
tutọ́|tutɔ́
twitter|twitter
tà|tà
tàbí|tàbí
tàbùkù|tàbùkù
tàjẹ̀|tàd͡ʒɛ̀
tàkúté|tàkúté
tàlàbí|tàlàbí
tàmẹ̀dùn|tàmɛ̀dùn
tàn|tàn
tànkálẹ̀|tànkálɛ̀
tànmọ́lẹ̀|tànmɔ́lɛ̀
tàntàn|tàntàn
tàpá|tàk͡pá
tàwa|tàwa
tààrà|tààrà
tá|tá
táa|táa
tábìlì|tábìlì
tádé|tádé
tájù|tád͡ʒù
tákàdá|tákàdá
tálákà|tálákà
tálẹ́ǹtì|tálɛ́ǹtì
tán|tán
táràrà|táràrà
táyà|tájà
táyé|tájé
táyọ̀|tájɔ̀
táíwò|táíwò
tèmi|tèmi
tèmítáyò|tèmítájò
tètè|tètè
tì|tì
tìbẹ̀rù|tìbɛ̀rù
tìfẹ́tìfẹ́|tìfɛ́tìfɛ́
tìjání|tìd͡ʒání
tìkálára|tìkálára
tìkára|tìkára
tìlẹ̀kùn|tìlɛ̀kùn
tìmílẹ́yìn|tìmílɛ́jìn
tìróò|tìróò
tìrẹ|tìrɛ
tìtorí|tìtorí
tìtì|tìtì
tìtì’|tìtì’
tìyanu|tìjanu
tìyín|tìjín
tìí|tìí
tìẹ|tìɛ
tí|tí
tímọ́tímọ́|tímɔ́tímɔ́
tírélà|tírélà
títa|títa
títanù|títanù
títo|títo
títà|títà
títàjẹ̀sílẹ̀|títàd͡ʒɛ̀sílɛ̀
títì|títì
títí|títí
títò|títò
tító|tító
títóbi|títóbi
títúmọ̀|títúmɔ̀
títún|títún
títúnṣe|títúnʃe
títẹ̀|títɛ̀
títẹ̀lé|títɛ̀lé
títẹ́|títɛ́
títọ́|títɔ́
títọ́jú|títɔ́d͡ʒú
títọ́’|títɔ́’
tíì|tíì
tíí|tíí
tò|tò
tòní|tòní
tòru|tòru
tòsí|tòsí
tòun|tòũ
tòògbé|tòòɡ͡bé
tòótọ́|tòótɔ́
tó|tó
tóbi|tóbi
tókù|tókù
tónítóní|tónítóní
tóo|tóo
tósìn|tósìn
tótòtó|tótòtó
tóun|tóũ
tóóró|tóóró
tù|tù
tùn|tùn
tùràrí|tùràrí
tùtù|tùtù
tú|tú
túbá|túbá
túbú|túbú
túbọ̀|túbɔ̀
tújúká|túd͡ʒúká
túká|túká
túláàsì|túláàsì
túmọ̀|túmɔ̀
tún|tún
túndé|túndé
túnjí|túnd͡ʒí
túnṣe|túnʃe
tútù|tútù
tútùṣùgbọ́n|tútùʃùɡ͡bɔ́n
túwó|túwó
túúbá|túúbá
túútúú|túútúú
túńjí|túńd͡ʒí
tú’|tú’
tẹ|tɛ
tẹjúmọ́|tɛd͡ʒúmɔ́
tẹlẹ̀|tɛlɛ̀
tẹmpili|tɛmk͡pili
tẹni|tɛ̃i
tẹnu|tɛ̃u
tẹnumọ́|tɛ̃umɔ́
tẹná|tɛ̃á
tẹra|tɛra
tẹramọ́|tɛramɔ́
tẹranko|tɛranko
tẹrí|tɛrí
tẹríba|tɛríba
tẹsalonika|tɛsalonika
tẹsẹ̀|tɛsɛ̀
tẹ̀|tɛ̀
tẹ̀bọmi|tɛ̀bɔmi
tẹ̀dó|tɛ̀dó
tẹ̀gàn|tɛ̀ɡàn
tẹ̀là|tɛ̀là
tẹ̀lé|tɛ̀lé
tẹ̀lẹ́|tɛ̀lɛ́
tẹ̀rì|tɛ̀rì
tẹ̀síwájú|tɛ̀síwád͡ʒú
tẹ̀tàn|tɛ̀tàn
tẹ̀yẹtẹ̀yẹ|tɛ̀jɛtɛ̀jɛ
tẹ́|tɛ́
tẹ́jú|tɛ́d͡ʒú
tẹ́lẹ̀|tɛ́lɛ̀
tẹ́lẹ̀tẹ́lẹ̀|tɛ́lɛ̀tɛ́lɛ̀
tẹ́tí|tɛ́tí
tẹ́tẹ́|tɛ́tɛ́
tẹ́wọ́|tɛ́wɔ́
tẹ́wọ́gbà|tɛ́wɔ́ɡ͡bà
tẹ́ẹ́rẹ́|tɛ́ɛ́rɛ́
tẹ’wọ́|tɛ’wɔ́
tọ|tɔ
tọkàntọkàn|tɔkàntɔkàn
tọkùnrin|tɔkùnrĩ
tọkọtaya|tɔkɔtaja
tọpinpin|tɔk͡pĩk͡pĩ
tọrẹ|tɔrɛ
tọwọ́|tɔwɔ́
tọwọ́tẹsẹ̀|tɔwɔ́tɛsɛ̀
tọ̀|tɔ̀
tọ̀nà|tɔ̀nà
tọ̀san|tɔ̀san
tọ̀sán|tɔ̀sán
tọ́|tɔ́
tọ́jà|tɔ́d͡ʒà
tọ́jú|tɔ́d͡ʒú
tọ́ka|tɔ́ka
tọ́lá|tɔ́lá
tọ́nisọ́nà|tɔ́nisɔ́nà
tọ́nà|tɔ́nà
tọ́rọ́|tɔ́rɔ́
tọ́wò|tɔ́wò
tọ́ọ|tɔ́ɔ
tọ́’|tɔ́’
tọ́’jà|tɔ́’d͡ʒà
t’abo|t’abo
t’akọ|t’akɔ
t’asẹ̀|t’asɛ̀
t’ìyàwó|t’ìjàwó
t’òní|t’òní
t’ójò|t’ód͡ʒò
t’ọko|t’ɔko
t’ọ̀la|t’ɔ̀la
ulai|ulai
ulamu|ulamu
un|ũ
united|ũited
un’|ũ’
urbani|urbani
uri|uri
uriah|uriah
urimu|urimu
usai|usai
usieli|usieli
ussa|ussa
ussi|ussi
ussiah|ussiah
u’|u’
wa|wa
wadi|wadi
wakọ̀|wakɔ̀
walẹ̀|walɛ̀
waà|waà
wa’|wa’
wo|wo
wolẹ̀|wolɛ̀
won|won
wonisàn|wonisàn
wo’ni|wo’ni
wu|wu
wugbọ́|wuɡ͡bɔ́
wà|wà
wàhálà|wàhálà
wàjà|wàd͡ʒà
wàláà|wàláà
wàrà|wàrà
wàràǹkàṣì|wàràǹkàʃì
wàyí|wàjí
wàyíì|wàjíì
wàá|wàá
wàásù|wàásù
wàídì|wàídì
wà’|wà’
wá|wá
wáa|wáa
wádìí|wádìí
wákàtí|wákàtí
wálé|wálé
wálẹ̀|wálɛ̀
wámú|wámú
wárápá|wárák͡pá
wárìrì|wárìrì
wárí|wárí
wáyé|wájé
wáìnì|wáìnì
wá’|wá’
wá’lẹ̀|wá’lɛ̀
wè|wè
wèrè|wèrè
wèrèpè|wèrèk͡pè
wé|wé
wéré|wéré
wéwu|wéwu
wí|wí
wíjọ́|wíd͡ʒɔ́
wílò|wílò
wílóò|wílóò
wín|wín
wípé|wík͡pé
wírù|wírù
wírú|wírú
wíwo|wíwo
wíwà|wíwà
wíwá|wíwá
wíwé|wíwé
wíwò|wíwò
wíwó|wíwó
wíwú|wíwú
wíwúwo|wíwúwo
wíwẹ|wíwɛ
wíwẹ̀|wíwɛ̀
wíwẹ́|wíwɛ́
wíwọlé|wíwɔlé
wíwọ̀|wíwɔ̀
wíwọ̀n|wíwɔ̀n
wíwọ́|wíwɔ́
wò|wò
wòkè|wòkè
wòlíì|wòlíì
wòlíì’|wòlíì’
wòran|wòran
wòsàn|wòsàn
wòye|wòje
wòó|wòó
wò’|wò’
wò’kè|wò’kè
wò’ṣe|wò’ʃe
wó|wó
wólẹ̀|wólɛ̀
wón|wón
wóo|wóo
wù|wù
wùkẹ̀wụ̀kẹ̀|wùkɛ̀wụ̀kɛ̀
wùkẹ́wụ̀kẹ́|wùkɛ́wụ̀kɛ́
wùnmí|wùnmí
wùwà|wùwà
wú|wú
wúlò|wúlò
wúrà|wúrà
wúwo|wúwo
wúńdíá|wúńdíá
wẹ̀|wɛ̀
wẹ̀mímọ́|wɛ̀mímɔ́
wẹ̀mọ́|wɛ̀mɔ́
wẹ̀nù|wɛ̀nù
wẹ̀nùmọ́|wɛ̀nùmɔ́
wẹ̀yìn|wɛ̀jìn
wẹ́rẹ́wẹ́rẹ́|wɛ́rɛ́wɛ́rɛ́
wẹ́wẹ́|wɛ́wɛ́
wẹẹrẹ|wɛɛrɛ
wọ|wɔ
wọlé|wɔlé
wọn|wɔ̃
wọnjanwọnjan|wɔ̃d͡ʒanwɔ̃d͡ʒan
wọnù|wɔ̃ù
wọnú|wɔ̃ú
wọnúọlá|wɔ̃úɔlá
wọn’|wɔ̃’
wọ̀|wɔ̀
wọ̀bìà|wɔ̀bìà
wọ̀kí|wɔ̀kí
wọ̀n|wɔ̀n
wọ̀nyí|wɔ̀njí
wọ̀nyí’|wɔ̀njí’
wọ̀ọ́|wɔ̀ɔ́
wọ̀’|wɔ̀’
wọ́|wɔ́
wọ́de|wɔ́de
wọ́dà|wɔ́dà
wọ́gọwọ̀gọ|wɔ́ɡɔwɔ̀ɡɔ
wọ́jọ|wɔ́d͡ʒɔ
wọ́n|wɔ́n
wọ́ntí|wɔ́ntí
wọ́nà|wɔ́nà
wọ́n’|wɔ́n’
wọ́n”|wɔ́n”
wọ́pọ̀|wɔ́k͡pɔ̀
wọ́ọ́rọ́|wɔ́ɔ́rɔ́
wọ’lé|wɔ’lé
wọ’nú|wɔ’nú
ya|ja
yadi|jadi
yan|jan
yangàn|janɡàn
yanjú|jand͡ʒú
yanrìn|janrìn
yanturu|janturu
yapa|jak͡pa
yarọ|jarɔ
yasó|jasó
yaya|jaja
yayaya|jajaja
ye|je
yege|jeɡe
yigbì|jiɡ͡bì
yin|jĩ
yinrin|jĩrĩ
yin’|jĩ’
yo|jo
yokù|jokù
yorùbá|jorùbá
yà|jà
yàgàn|jàɡàn
yàgò|jàɡò
yàn|jàn
yànmúyańmú|jànmújańmú
yànàná|jànàná
yàra|jàra
yàrá|jàrá
yàtọ̀|jàtɔ̀
yá|já
yálà|jálà
yáná|jáná
yára|jára
yè|jè
yèyé|jèjé
yé|jé
yékéyéke|jékéjéke
yékéyéké|jékéjéké
yétúndé|jétúndé
yéwandé|jéwandé
yéèpà|jéèk͡pà
yìn|jìn
yìnyín|jìnjín
yìí|jìí
yìíi|jìíi
yìíláti|jìíláti
yìíì|jìíì
yìí’|jìí’
yìí”|jìí”
yí|jí
yídì|jídì
yíjú|jíd͡ʒú
yíká|jíká
yíkákiri|jíkákiri
yílẹ̀|jílɛ̀
yín|jín
yínmú|jínmú
yínṣùgbọ́n|jínʃùɡ͡bɔ́n
yínẹ|jínɛ
yín’|jín’
yípadà|jík͡padà
yípo|jík͡po
yíràá|jíràá
yíya|jíja
yíyan|jíjan
yíyanjú|jíjand͡ʒú
yíyà|jíjà
yíyàgàn|jíjàɡàn
yíyàn|jíjàn
yíyànmí|jíjànmí
yíyè|jíjè
yíyìn|jíjìn
yíyí|jíjí
yíyípadà|jíjík͡padà
yíyẹ|jíjɛ
yíyọ́|jíjɔ́
yíì|jíì
yòrùbá|jòrùbá
yòókù|jòókù
yó|jó
yóo|jóo
yówù|jówù
yóò|jóò
yún|jún
yẹ|jɛ
yẹgi|jɛɡi
yẹn|jɛ̃
yẹpẹrẹ|jɛk͡pɛrɛ
yẹra|jɛra
yẹrí|jɛrí
yẹtí|jɛtí
yẹ̀|jɛ̀
yẹ̀míwò|jɛ̀míwò
yẹ̀rì|jɛ̀rì
yẹ̀yẹ́|jɛ̀jɛ́
yẹ́|jɛ́
yẹ́n|jɛ́n
yọ|jɔ
yọjú|jɔd͡ʒú
yọrí|jɔrí
yọrísí|jɔrísí
yọ̀|jɔ̀
yọ̀ǹda|jɔ̀ǹda
yọ́|jɔ́
y’óhùn|j’óhùn
y’ọjú|j’ɔd͡ʒú
à|à
àafin|àafĩ
àarín|àarín
àbojútó|àbod͡ʒútó
àbàtà|àbàtà
àbàwọ́n|àbàwɔ́n
àbá|àbá
àbájáde|àbád͡ʒáde
àbáláyé|àbálájé
àbámẹ́ta|àbámɛ́ta
àbámọ̀|àbámɔ̀
àbáwọlé|àbáwɔlé
àbáyọ|àbájɔ
àbí|àbí
àbígbẹ̀yìn|àbíɡ͡bɛ̀jìn
àbíkú|àbíkú
àbíkẹ́hìn|àbíkɛ́hìn
àbíkẹ́yìn|àbíkɛ́jìn
àbírì|àbírì
àbòsí|àbòsí
àbùbùtán|àbùbùtán
àbùdá|àbùdá
àbùkù|àbùkù
àbújá|àbúd͡ʒá
àbúrò|àbúrò
àbẹ̀gbé|àbɛ̀ɡ͡bé
àbẹ̀kẹ́|àbɛ̀kɛ́
àbẹ̀tẹ́lẹ̀|àbɛ̀tɛ́lɛ̀
àbẹ́gbẹ́|àbɛ́ɡ͡bɛ́
àbọ̀|àbɔ̀
àbọ́|àbɔ́
àdàbà|àdàbà
àdàkọ|àdàkɔ
àdàlú|àdàlú
àdàmọ̀dì|àdàmɔ̀dì
àdá|àdá
àdábọwọ́|àdábɔwɔ́
àdákọ|àdákɔ
àdán|àdán
àdánidá|àdánidá
àdánwò|àdánwò
àdèlé|àdèlé
àdèyí|àdèjí
àdéhùn|àdéhùn
àdìgún|àdìɡún
àdìrẹ|àdìrɛ
àdìó|àdìó
àdídùn|àdídùn
àdògán|àdòɡán
àdó|àdó
àdùké|àdùké
àdùkẹ́|àdùkɛ́
àdùnní|àdùnní
àdúgbò|àdúɡ͡bò
àdúrà|àdúrà
àdúrà’|àdúrà’
àdúrótì|àdúrótì
àdẹ́dọ̀|àdɛ́dɔ̀
àfarawé|àfarawé
àfi|àfi
àfihàn|àfihàn
àfikún|àfikún
àfin|àfĩ
àfinásun|àfĩásũ
àfipáṣe|àfik͡páʃe
àfiwé|àfiwé
àfiyèsí|àfijèsí
àfi’ìgbà|àfi’ìɡ͡bà
àfojúdi|àfod͡ʒúdi
àfojúsùn|àfod͡ʒúsùn
àfonífojì|àfonífod͡ʒì
àforíjì|àforíd͡ʒì
àfàìmọ̀|àfàìmɔ̀
àfá|àfá
àfín|àfín
àfẹ̀mọ́júmọ́|àfɛ̀mɔ́d͡ʒúmɔ́
àfẹ́jù|àfɛ́d͡ʒù
àfẹ́rí|àfɛ́rí
àfẹ́sọ́nà|àfɛ́sɔ́nà
àfọwọ́gbá|àfɔwɔ́ɡ͡bá
àfọ̀mọ́|àfɔ̀mɔ́
àfọ̀ṣẹ|àfɔ̀ʃɛ
àf’ìgbà|àf’ìɡ͡bà
àga|àɡa
àgbantara|àɡ͡bantara
àgbo|àɡ͡bo
àgbà|àɡ͡bà
àgbàdo|àɡ͡bàdo
àgbàgbà|àɡ͡bàɡ͡bà
àgbàlagbà|àɡ͡bàlaɡ͡bà
àgbàlá|àɡ͡bàlá
àgbàrá|àɡ͡bàrá
àgbàtọ́jú|àɡ͡bàtɔ́d͡ʒú
àgbàwọ̀|àɡ͡bàwɔ̀
àgbàyanu|àɡ͡bàjanu
àgbá|àɡ͡bá
àgbájọ|àɡ͡bád͡ʒɔ
àgbálùmọ́|àɡ͡bálùmɔ́
àgbáyé|àɡ͡bájé
àgbáńlá|àɡ͡báńlá
àgbègbè|àɡ͡bèɡ͡bè
àgbèrè|àɡ͡bèrè
àgbébọ̀|àɡ͡bébɔ̀
àgbékalè|àɡ͡békalè
àgbékalẹ̀|àɡ͡békalɛ̀
àgbékà|àɡ͡békà
àgbélébùú|àɡ͡bélébùú
àgbélébú|àɡ͡bélébú
àgbéléwo|àɡ͡béléwo
àgbéléwò|àɡ͡béléwò
àgbéléwọ̀|àɡ͡béléwɔ̀
àgbò|àɡ͡bò
àgbònrín|àɡ͡bònrín
àgbẹ̀|àɡ͡bɛ̀
àgbọn|àɡ͡bɔ̃
àgbọye|àɡ͡bɔje
àgbọ̀n|àɡ͡bɔ̀n
àgbọ̀nrín|àɡ͡bɔ̀nrín
àgbọ́yé|àɡ͡bɔ́jé
àgàbàgebè|àɡàbàɡebè
àgàn|àɡàn
àgádàgodo|àɡádàɡodo
àgékù|àɡékù
àgò|àɡò
àgòrò|àɡòrò
àgùnbánirọ̀|àɡùnbánirɔ̀
àgùntàn|àɡùntàn
àgùntàn’|àɡùntàn’
àgùtàn|àɡùtàn
àgẹ̀ẹ̀rẹ̀|àɡɛ̀ɛ̀rɛ̀
àgọ́|àɡɔ́
àhesọ|àhesɔ
àhámọ́|àhámɔ́
àjà|àd͡ʒà
àjàgà|àd͡ʒàɡà
àjàká|àd͡ʒàká
àjàkálẹ̀|àd͡ʒàkálɛ̀
àjàlá|àd͡ʒàlá
àjànàkú|àd͡ʒànàkú
àjàrà|àd͡ʒàrà
àjàsín|àd͡ʒàsín
àjàṣẹ́|àd͡ʒàʃɛ́
àjá|àd͡ʒá
àjáh|àd͡ʒáh
àjálù|àd͡ʒálù
àjárá|àd͡ʒárá
àjásin|àd͡ʒásĩ
àjèjì|àd͡ʒèd͡ʒì
àjíǹde|àd͡ʒíǹde
àjò|àd͡ʒò
àjòjì|àd͡ʒòd͡ʒì
àjóòkú|àd͡ʒóòkú
àjùmọ̀jogún|àd͡ʒùmɔ̀d͡ʒoɡún
àjẹgbádùn|àd͡ʒɛɡ͡bádùn
àjẹjù|àd͡ʒɛd͡ʒù
àjẹkì|àd͡ʒɛkì
àjẹkù|àd͡ʒɛkù
àjẹtì|àd͡ʒɛtì
àjẹtẹ́rùn|àd͡ʒɛtɛ́rùn
àjẹyó|àd͡ʒɛjó
àjẹ́|àd͡ʒɛ́
àjọ|àd͡ʒɔ
àjọpín|àd͡ʒɔk͡pín
àjọyọ̀|àd͡ʒɔjɔ̀
àjọ̀dún|àd͡ʒɔ̀dún
àkekèé|àkekèé
àkotọ́|àkotɔ́
àkàlàmàgbò|àkàlàmàɡ͡bò
àkànbí|àkànbí
àkàndé|àkàndé
àkàndùn|àkàndùn
àkànmú|àkànmú
àkànṣe|àkànʃe
àkàrà|àkàrà
àkàsọ̀|àkàsɔ̀
àkàwé|àkàwé
àkàyìmọye|àkàjìmɔje
àkàìmọye|àkàìmɔje
àká|àká
àkèré|àkèré
àkéekèe|àkéekèe
àkéte|àkéte
àkìmọ́lẹ̀|àkìmɔ́lɛ̀
àkìtàn|àkìtàn
àkísà|àkísà
àkíyesí|àkíjesí
àkíyèsí|àkíjèsí
àkòrí|àkòrí
àkóbọ̀|àkóbɔ̀
àkójá|àkód͡ʒá
àkójọ|àkód͡ʒɔ
àkójọpọ̀|àkód͡ʒɔk͡pɔ̀
àkókò|àkókò
àkókó|àkókó
àkópọ̀|àkók͡pɔ̀
àkóso|àkóso
àkótán|àkótán
àkùkọ|àkùkɔ
àkúnwọ́sílẹ̀|àkúnwɔ́sílɛ̀
àkúrẹ́|àkúrɛ́
àkẹ̀sán|àkɛ̀sán
àkọlé|àkɔlé
àkọsílẹ̀|àkɔsílɛ̀
àkọtọ́|àkɔtɔ́
àkọ̀|àkɔ̀
àkọ́|àkɔ́
àkọ́bí|àkɔ́bí
àkọ́kọ́|àkɔ́kɔ́
àkọ́pò|àkɔ́k͡pò
àkọ́rọ̀|àkɔ́rɔ̀
àkọ́so|àkɔ́so
àlejò|àled͡ʒò
àlejòo|àled͡ʒòo
àlà|àlà
àlàfo|àlàfo
àlàhájì|àlàhád͡ʒì
àlàkalẹ̀|àlàkalɛ̀
àlàyé|àlàjé
àlàáfíà|àlàáfíà
àlá|àlá
àláfíà|àláfíà
àlákála|àlákála
àlááfíà|àlááfíà
àlè|àlè
àlébù|àlébù
àléfà|àléfà
àlìkámà|àlìkámà
àlùbáríkà|àlùbáríkà
àlùbọ́sà|àlùbɔ́sà
àlùfá|àlùfá
àlùfáà|àlùfáà
àlùjó|àlùd͡ʒó
àlùkò|àlùkò
àlúpàyídà|àlúk͡pàjídà
àl̀àkẹ́|àl̀àkɛ́
àlọ|àlɔ
àlọ́|àlɔ́
àmi|àmi
àmin|àmĩ
àmupara|àmuk͡para
àmuparaolúwa|àmuk͡paraolúwa
àmuyó|àmujó
àmàlà|àmàlà
àmì|àmì
àmìpọ̀|àmìk͡pɔ̀
àmídà|àmídà
àmín|àmín
àmínátù|àmínátù
àmín’|àmín’
àmójúkúrò|àmód͡ʒúkúrò
àmù|àmù
àmùrè|àmùrè
àmúga|àmúɡa
àmúlò|àmúlò
àmúrelé|àmúrelé
àmútọ̀runwá|àmútɔ̀rũwá
àmúyẹ|àmújɛ
àmúṣẹ|àmúʃɛ
àmọlé|àmɔlé
àmọ̀jù|àmɔ̀d͡ʒù
àmọ̀pé|àmɔ̀k͡pé
àmọ̀tẹ́kùn|àmɔ̀tɛ́kùn
àmọ́|àmɔ́
àmọ́dù|àmɔ́dù
àmọ́dún|àmɔ́dún
àna|àna
ànà|ànà
àná|àná
àní|àní
ànító|ànító
àníyàn|àníjàn
àníṣẹ́kù|àníʃɛ́kù
ànọ́bi|ànɔ́bi
àpadàsáburú|àk͡padàsáburú
àpamọ́wọ́|àk͡pamɔ́wɔ́
àpapọ̀|àk͡pak͡pɔ̀
àpilẹ̀kọ|àk͡pilɛ̀kɔ
àpinlẹ̀kọ|àk͡pĩlɛ̀kɔ
àpo|àk͡po
àpá|àk͡pá
àpápá|àk͡pák͡pá
àpáta|àk͡páta
àpáàdì|àk͡páàdì
àpèjúwe|àk͡pèd͡ʒúwe
àpèjẹ|àk͡pèd͡ʒɛ
àpèjọ|àk͡pèd͡ʒɔ
àpèlé|àk͡pèlé
àpéjọ|àk͡péd͡ʒɔ
àpéjọpọ̀|àk͡péd͡ʒɔk͡pɔ̀
àpékẹ́|àk͡pékɛ́
àpò|àk͡pò
àpótí|àk͡pótí
àpẹ̀ẹ̀rẹ̀|àk͡pɛ̀ɛ̀rɛ̀
àpẹẹrẹ|àk͡pɛɛrɛ
àpọ̀|àk͡pɔ̀
àpọ́n|àk͡pɔ́n
àpọ́nlé|àk͡pɔ́nlé
àra|àra
àrankàn|àrankàn
àre|àre
àrun|àrũ
àrà|àrà
àràbà|àràbà
àràfá|àràfá
àrànmọ́|àrànmɔ́
àràádọ́ta|àràádɔ́ta
àràárọ̀|àràárɔ̀
àrá|àrá
àrè|àrè
àrèó|àrèó
àrékérekè|àrékérekè
àríkẹ́|àríkɛ́
àríkẹ́adé|àríkɛ́adé
àríwá|àríwá
àríyànjiyàn|àríjànd͡ʒijàn
àríyá|àríjá
àrò|àrò
àròsọ|àròsɔ
àròyé|àròjé
àródan|àródan
àrólé|àrólé
àrósọ|àrósɔ
àrùndínlọ́gọ́rin|àrùndínlɔ́ɡɔ́rĩ
àrẹ|àrɛ
àrẹ̀mú|àrɛ̀mú
àrẹ̀mọ|àrɛ̀mɔ
àrọ̀|àrɔ̀
àrọ̀kúrò|àrɔ̀kúrò
àrọ́júṣe|àrɔ́d͡ʒúʃe
àrọ́ko|àrɔ́ko
àrọ́mọdọ́mọ|àrɔ́mɔdɔ́mɔ
àrọ́wọ́tó|àrɔ́wɔ́tó
àsogbó|àsoɡ͡bó
àsàwọ́|àsàwɔ́
àsálà|àsálà
àsápájúdé|àsák͡pád͡ʒúdé
àsáró|àsáró
àsáwọ̀|àsáwɔ̀
àsè|àsè
àsìkò|àsìkò
àsígbè|àsíɡ͡bè
àsíá|àsíá
àsọtẹ́lẹ̀|àsɔtɛ́lɛ̀
àsọyé|àsɔjé
àtabo|àtabo
àtakò|àtakò
àtakọ|àtakɔ
àti|àti
àtijó|àtid͡ʒó
àtijọ́|àtid͡ʒɔ́
àtilà|àtilà
àtilọ|àtilɔ
àtinúwá|àtĩúwá
àtiwọ|àtiwɔ
àtiyọ|àtijɔ
àtubọ̀tán|àtubɔ̀tán
àtàrí|àtàrí
àtàtà|àtàtà
àtàǹpàkò|àtàǹk͡pàkò
àtètèkọ́|àtètèkɔ́
àtètèkọ́ṣe|àtètèkɔ́ʃe
àtìgbàdégbà|àtìɡ͡bàdéɡ͡bà
àtìlẹ́yìn|àtìlɛ́jìn
àtìpó|àtìk͡pó
àtíbàbà|àtíbàbà
àtíbàbá|àtíbàbá
àtíkè|àtíkè
àtòrì|àtòrì
àtùpà|àtùk͡pà
àtúnbí|àtúnbí
àtúnkọ́|àtúnkɔ́
àtúnwí|àtúnwí
àtúnṣe|àtúnʃe
àtẹ|àtɛ
àtẹjúmọ́|àtɛd͡ʒúmɔ́
àtẹ̀gùn|àtɛ̀ɡùn
àtẹ̀jíṣẹ́|àtɛ̀d͡ʒíʃɛ́
àtẹ̀lé|àtɛ̀lé
àtẹ̀wọ|àtɛ̀wɔ
àtẹ̀yìnwá|àtɛ̀jìnwá
àtẹ́|àtɛ́
àtẹ́lẹsẹ̀|àtɛ́lɛsɛ̀
àtẹ́lẹwọ́|àtɛ́lɛwɔ́
àtẹ́rígbà|àtɛ́ríɡ͡bà
àtọkànwá|àtɔkànwá
àtọwọ́dọ́wọ́|àtɔwɔ́dɔ́wɔ́
àtọ̀húnrìnwá|àtɔ̀húnrìnwá
àtọ̀runwá|àtɔ̀rũwá
àt’àná|àt’àná
àt’ẹ̀kọ|àt’ɛ̀kɔ
àt’ẹ̀wà|àt’ɛ̀wà
àwa|àwa
àwo|àwo
àwokòtò|àwokòtò
àwon|àwon
àwopọ̀kọ́|àwok͡pɔ̀kɔ́
àwopọ̀kọ́”|àwok͡pɔ̀kɔ́”
àwàdà|àwàdà
àwàjálẹ̀|àwàd͡ʒálɛ̀
àwámárììdí|àwámárììdí
àwámárídìí|àwámárídìí
àwárí|àwárí
àwáwí|àwáwí
àwáyè|àwájè
àwíjàre|àwíd͡ʒàre
àwíìyánnu|àwíìjánnu
àwòjìji|àwòd͡ʒìd͡ʒi
àwòkọ́ṣe|àwòkɔ́ʃe
àwòrán|àwòrán
àwòtán|àwòtán
àwòyanu|àwòjanu
àwùjọ|àwùd͡ʒɔ
àwẹ̀|àwɛ̀
àwẹ̀ìwẹ̀tán|àwɛ̀ìwɛ̀tán
àwọn|àwɔ̃
àwọsánmọ̀|àwɔsánmɔ̀
àwọ̀|àwɔ̀
àwọ̀n|àwɔ̀n
àwọ̀tẹ́lẹ̀|àwɔ̀tɛ́lɛ̀
àwọ́n|àwɔ́n
àwọ̣n|àwɔ̣n
àya|àja
àyà|àjà
àyàfi|àjàfi
àyànfẹ́|àjànfɛ́
àyànmọ́|àjànmɔ́
àyándélé|àjándélé
àyétán|àjétán
àyìnlá|àjìnlá
àyídà|àjídà
àyídáyidà|àjídájidà
àyíká|àjíká
àyípadà|àjík͡padà
àyẹ̀wò|àjɛ̀wò
àyẹ́sí|àjɛ́sí
àyọnusọ|àjɔ̃usɔ
àyọríṣí|àjɔríʃí
ààbò|ààbò
ààbọ̀|ààbɔ̀
ààfin|ààfĩ
ààfáà|ààfáà
ààlà|ààlà
ààló|ààló
ààlọ́|ààlɔ́
ààrò|ààrò
ààrùn|ààrùn
ààrẹ|ààrɛ
ààtàn|ààtàn
ààyè|ààjè
ààyè’|ààjè’
ààyò|ààjò
àádóje|àádód͡ʒe
àádọ́fà|àádɔ́fà
àádọ́jọ|àádɔ́d͡ʒɔ
àádọ́rin|àádɔ́rĩ
àádọ́rùn|àádɔ́rùn
àádọ́ta|àádɔ́ta
àágùn|àáɡùn
àáké|àáké
àánú|àánú
àárin|àárĩ
àárín|àárín
àárò|àárò
àárùn|àárùn
àárẹ̀|àárɛ̀
àárọ̀|àárɔ̀
àìbalẹ̀|àìbalɛ̀
àìbìkítà|àìbìkítà
àìbúra|àìbúra
àìbẹ̀rù|àìbɛ̀rù
àìbọ̀wọ̀|àìbɔ̀wɔ̀
àìdá|àìdá
àìdálẹ́bi|àìdálɛ́bi
àìdánilójú|àìdánilód͡ʒú
àìdíbàjẹ́|àìdíbàd͡ʒɛ́
àìdọ́gba|àìdɔ́ɡ͡ba
àìfarabalẹ̀|àìfarabalɛ̀
àìfẹ́|àìfɛ́
àìgbàgbọ́|àìɡ͡bàɡ͡bɔ́
àìgbó|àìɡ͡bó
àìgbọdọ̀|àìɡ͡bɔdɔ̀
àìgbọ́fá|àìɡ͡bɔ́fá
àìgbọ́ràn|àìɡ͡bɔ́ràn
àìjiyàn|àìd͡ʒijàn
àìjẹun|àìd͡ʒɛũ
àìjẹ̀bi|àìd͡ʒɛ̀bi
àìkàsí|àìkàsí
àìkáárẹ̀|àìkáárɛ̀
àìkú|àìkú
àìkún|àìkún
àìkọlà|àìkɔlà
àìlera|àìlera
àìlábàwọ́n|àìlábàwɔ́n
àìlábámọ̀|àìlábámɔ̀
àìlábùkù|àìlábùkù
àìlábùlà|àìlábùlà
àìlèfojúrí|àìlèfod͡ʒúrí
àìlèmáradúró|àìlèmáradúró
àìlèyípadà|àìlèjík͡padà
àìlérè|àìlérè
àìléwu|àìléwu
àìléèérí|àìléèérí
àìlófin|àìlófĩ
àìlópin|àìlók͡pĩ
àìlẹ́gàn|àìlɛ́ɡàn
àìlẹ́wà|àìlɛ́wà
àìlọ́lá|àìlɔ́lá
àìlọ́mọ|àìlɔ́mɔ
àìlọ́wọ̀|àìlɔ́wɔ̀
àìmoye|àìmoje
àìmúra|àìmúra
àìmọ̀|àìmɔ̀
àìmọ̀kan|àìmɔ̀kan
àìmọ̀ọ́mọ̀dá|àìmɔ̀ɔ́mɔ̀dá
àìmọ́|àìmɔ́
àìmọ́’|àìmɔ́’
àìná|àìná
àìnání|àìnání
àìní|àìní
àìnídìí|àìnídìí
àìnídìí’|àìnídìí’
àìnípẹ̀kun|àìník͡pɛ̀kũ
àìnírètí|àìnírètí
àìnítẹ́lọ́rùn|àìnítɛ́lɔ́rùn
àìníye|àìníje
àìpatán|àìk͡patán
àìpò|àìk͡pò
àìpẹ́|àìk͡pɛ́
àìronúpìwàdà|àìronúk͡pìwàdà
àìrékọjá|àìrékɔd͡ʒá
àìrí|àìrí
àìríran|àìríran
àìròtẹ́lẹ̀|àìròtɛ́lɛ̀
àìsimi|àìsimi
àìsàn|àìsàn
àìsí|àìsí
àìsùn|àìsùn
àìtòrò|àìtòrò
àìtó|àìtó
àìtọ́|àìtɔ́
àìtọ́jú|àìtɔ́d͡ʒú
àìwà|àìwà
àìwú|àìwú
àìwúkàrà|àìwúkàrà
àìwọṣọ|àìwɔʃɔ
àìyedè|àìjedè
àìṣe|àìʃe
àìṣedéédéé|àìʃedéédéé
àìṣiyèméjì|àìʃijèméd͡ʒì
àìṣègbè|àìʃèɡ͡bè
àìṣòdodo|àìʃòdodo
àìṣòótọ́|àìʃòótɔ́
àìṣẹ̀tàn|àìʃɛ̀tàn
àìṣọ̀lẹ|àìʃɔ̀lɛ
àńjọlá|àńd͡ʒɔlá
àńjọláolúwa|àńd͡ʒɔláolúwa
àǹfàní|àǹfàní
àǹfààní|àǹfààní
àǹkárá|àǹkárá
àṣansílẹ̀|àʃansílɛ̀
àṣehàn|àʃehàn
àṣejù|àʃed͡ʒù
àṣekágbá|àʃekáɡ͡bá
àṣekára|àʃekára
àṣekù|àʃekù
àṣepé|àʃek͡pé
àṣepé’|àʃek͡pé’
àṣeyege|àʃejeɡe
àṣeyọrí|àʃejɔrí
àṣà|àʃà
àṣàkẹ́|àʃàkɛ́
àṣàrò|àʃàrò
àṣàyàn|àʃàjàn
àṣá|àʃá
àṣálẹ́|àʃálɛ́
àṣápa|àʃák͡pa
àṣáró|àʃáró
àṣé|àʃé
àṣémọ́|àʃémɔ́
àṣìtẹ̀|àʃìtɛ̀
àṣìṣe|àʃìʃe
àṣíborí|àʃíborí
àṣírí|àʃírí
àṣẹ|àʃɛ
àṣẹ̀ṣẹ̀yọ|àʃɛ̀ʃɛ̀jɔ
àṣẹ́kù|àʃɛ́kù
á|á
ábbà|ábbà
ádámọ̀|ádámɔ̀
ájàó|ád͡ʒàó
án|án
ápù|ák͡pù
áà|áà
áàdọ́jọ|áàdɔ́d͡ʒɔ
á’|á’
è|è
èbìtì|èbìtì
èbùté|èbùté
èbúté|èbúté
ède|ède
èdá|èdá
èdè|èdè
èdè’|èdè’
èdìdì|èdìdì
èdùmàrè|èdùmàrè
ègbo|èɡ͡bo
ègbè|èɡ͡bè
ègbé|èɡ͡bé
ègé|èɡé
ègún|èɡún
èhíhù|èhíhù
èjè|èd͡ʒè
èjì|èd͡ʒì
èjìgbò|èd͡ʒìɡ͡bò
èjìgbòmẹkùn|èd͡ʒìɡ͡bòmɛkùn
èjìká|èd͡ʒìká
èjìrẹ́|èd͡ʒìrɛ́
èjí|èd͡ʒí
èkan|èkan
èkeje|èked͡ʒe
èkejì|èked͡ʒì
èkejìlá|èked͡ʒìlá
èkááná|èkááná
èké|èké
èkée|èkée
èké’|èké’
èkínní|èkínní
èkíní|èkíní
èkó|èkó
èkùrọ́|èkùrɔ́
èkúté|èkúté
èlé|èlé
èlé’|èlé’
èlò|èlò
èló|èló
èlùbọ́|èlùbɔ́
èmi|èmi
èmánúẹ̀lì|èmánúɛ̀lì
èmí|èmí
ènìyàn|ènìjàn
ènìyànkénìyàn|ènìjànkénìjàn
ènìyànṣùgbọ́n|ènìjànʃùɡ͡bɔ́n
ènìyàn’|ènìjàn’
èní|èní
èpè|èk͡pè
èpò|èk͡pò
ère|ère
èrè|èrè
èrèdí|èrèdí
èré|èré
èrí|èrí
èrò|èrò
èròjà|èròd͡ʒà
èròkerò|èròkerò
èróngbà|èrónɡ͡bà
èrú|èrú
èrúnrún|èrúnrún
èso|èso
èsì|èsì
èsúró|èsúró
ète|ète
ètè|ètè
ètò|ètò
ètùtù|ètùtù
èwe|èwe
èwo|èwo
èwù|èwù
èyan|èjan
èyàn|èjàn
èyì|èjì
èyí|èjí
èyíkéyìí|èjíkéjìí
èyíohun|èjíohũ
èyí’|èjí’
èèkàn|èèkàn
èèpo|èèk͡po
èèwọ̀|èèwɔ̀
èèyàn|èèjàn
èé|èé
èébì|èébì
èébú|èébú
èédú|èédú
èéfín|èéfín
èéha|èéha
èéhù|èéhù
èékán|èékán
èékánná|èékánná
èékánnáà|èékánnáà
èélá|èélá
èémí|èémí
èérí|èérí
èérún|èérún
èétirí|èétirí
èétiṣe|èétiʃe
èéṣe|èéʃe
èéṣì|èéʃì
è̀nìyàn|è̀nìjàn
èṣítẹ̀rí|èʃítɛ̀rí
èṣù|èʃù
èṣù’|èʃù’
é|é
élújọbí|élúd͡ʒɔbí
é’|é’
ì|ì
ìbejì|ìbed͡ʒì
ìbojútó|ìbod͡ʒútó
ìbora|ìbora
ìbà|ìbà
ìbàdàn|ìbàdàn
ìbàdí|ìbàdí
ìbàjẹ́|ìbàd͡ʒɛ́
ìbàlẹ̀|ìbàlɛ̀
ìbànújẹ́|ìbànúd͡ʒɛ́
ìbá|ìbá
ìbáaka|ìbáaka
ìbágbé|ìbáɡ͡bé
ìbágbépọ̀|ìbáɡ͡bék͡pɔ̀
ìbákasẹ|ìbákasɛ
ìbálé|ìbálé
ìbálòpò|ìbálòk͡pò
ìbálòpọ̀|ìbálòk͡pɔ̀
ìbámu|ìbámu
ìbánisọ̀rọ̀|ìbánisɔ̀rɔ̀
ìbániwí|ìbániwí
ìbárẹ́|ìbárɛ́
ìbátan|ìbátan
ìbáwí|ìbáwí
ìbáṣepọ̀|ìbáʃek͡pɔ̀
ìbéyàwó|ìbéjàwó
ìbéèrè|ìbéèrè
ìbéérè|ìbéérè
ìbìlù|ìbìlù
ìbìnújẹ́|ìbìnúd͡ʒɛ́
ìbí|ìbí
ìbílẹ̀|ìbílɛ̀
ìbímọ|ìbímɔ
ìbínú|ìbínú
ìbísí|ìbísí
ìbò|ìbò
ìbògùn|ìbòɡùn
ìbòjú|ìbòd͡ʒú
ìbòrí|ìbòrí
ìbùkún|ìbùkún
ìbùkúnwọ́|ìbùkúnwɔ́
ìbùsùn|ìbùsùn
ìbùwọ́n|ìbùwɔ́n
ìbú|ìbú
ìbúra|ìbúra
ìbẹ̀rù|ìbɛ̀rù
ìbẹ̀rùbojo|ìbɛ̀rùbod͡ʒo
ìbẹ̀rẹ̀|ìbɛ̀rɛ̀
ìbẹ̀wò|ìbɛ̀wò
ìbẹ́pẹ|ìbɛ́k͡pɛ
ìbọn|ìbɔ̃
ìbọ̀rìṣà|ìbɔ̀rìʃà
ìbọ̀wọ̀|ìbɔ̀wɔ̀
ìdahoro|ìdahoro
ìdajì|ìdad͡ʒì
ìdarí|ìdarí
ìdin|ìdĩ
ìdodo|ìdodo
ìdojúkojú|ìdod͡ʒúkod͡ʒú
ìdojúkọ|ìdod͡ʒúkɔ
ìdun|ìdũ
ìdàgbàsókè|ìdàɡ͡bàsókè
ìdàkejì|ìdàked͡ʒì
ìdàpọ̀|ìdàk͡pɔ̀
ìdàrúdàpọ̀|ìdàrúdàk͡pɔ̀
ìdààmú|ìdààmú
ìdá|ìdá
ìdábùú|ìdábùú
ìdádúró|ìdádúró
ìdágbére|ìdáɡ͡bére
ìdágìrì|ìdáɡìrì
ìdáhùn|ìdáhùn
ìdájí|ìdád͡ʒí
ìdájọ́|ìdád͡ʒɔ́
ìdájọ́ní|ìdád͡ʒɔ́ní
ìdákan|ìdákan
ìdákẹ́|ìdákɛ́
ìdákẹ́rọ́rọ́|ìdákɛ́rɔ́rɔ́
ìdákọ̀ró|ìdákɔ̀ró
ìdáláre|ìdáláre
ìdálóró|ìdálóró
ìdálẹ́|ìdálɛ́
ìdálẹ́bi|ìdálɛ́bi
ìdámárùn|ìdámárùn
ìdámẹ́rin|ìdámɛ́rĩ
ìdámẹ́ta|ìdámɛ́ta
ìdámẹ́wàá|ìdámɛ́wàá
ìdámọ̀|ìdámɔ̀
ìdánilárayá|ìdánilárajá
ìdánilójú|ìdánilód͡ʒú
ìdánimọ̀|ìdánimɔ̀
ìdánwò|ìdánwò
ìdáná|ìdáná
ìdárayá|ìdárajá
ìdáríjì|ìdáríd͡ʒì
ìdásílẹ̀|ìdásílɛ̀
ìdáwó|ìdáwó
ìdáwọ́lé|ìdáwɔ́lé
ìdáàbòbò|ìdáàbòbò
ìdáǹdè|ìdáǹdè
ìdè|ìdè
ìdènà|ìdènà
ìdì|ìdì
ìdìbò|ìdìbò
ìdìde|ìdìde
ìdìgbòlù|ìdìɡ͡bòlù
ìdìmú|ìdìmú
ìdìtẹ̀|ìdìtɛ̀
ìdí|ìdí
ìdíbàjẹ́|ìdíbàd͡ʒɛ́
ìdíbàjẹ́’|ìdíbàd͡ʒɛ́’
ìdíje|ìdíd͡ʒe
ìdílé|ìdílé
ìdíwọ́|ìdíwɔ́
ìdójúti|ìdód͡ʒúti
ìdójútì|ìdód͡ʒútì
ìdùbúlẹ̀|ìdùbúlɛ̀
ìdùnnú|ìdùnnú
ìdúmọ̀tà|ìdúmɔ̀tà
ìdúnmọ̀tà|ìdúnmɔ̀tà
ìdúpẹ́|ìdúk͡pɛ́
ìdúró|ìdúró
ìdẹwò|ìdɛwò
ìdẹ̀kùn|ìdɛ̀kùn
ìdọ̀tí|ìdɔ̀tí
ìdọ́gba|ìdɔ́ɡ͡ba
ìfami|ìfami
ìfarabalẹ̀|ìfarabalɛ̀
ìfaradà|ìfaradà
ìfarahàn|ìfarahàn
ìfarajì|ìfarad͡ʒì
ìfarapa|ìfarak͡pa
ìfaratì|ìfaratì
ìfi|ìfi
ìfibú|ìfibú
ìfifúnni|ìfifúnni
ìfihàn|ìfihàn
ìfikún|ìfikún
ìfilé|ìfilé
ìfinijoyè|ìfĩid͡ʒojè
ìfinisùn|ìfĩisùn
ìfipamọ́|ìfik͡pamɔ́
ìfipámúniṣe|ìfik͡pámúniʃe
ìfiré|ìfiré
ìfisùn|ìfisùn
ìfisọ̀rọ̀|ìfisɔ̀rɔ̀
ìfiṣẹ̀sín|ìfiʃɛ̀sín
ìfojúsùn|ìfod͡ʒúsùn
ìfojúsọ́nà|ìfod͡ʒúsɔ́nà
ìfojúṣọ́nà|ìfod͡ʒúʃɔ́nà
ìforíbalẹ̀|ìforíbalɛ̀
ìforítì|ìforítì
ìfowópamọ́|ìfowók͡pamɔ́
ìfowóṣòfò|ìfowóʃòfò
ìfun|ìfũ
ìfàsẹ́yìn|ìfàsɛ́jìn
ìfèdèfọ̀|ìfèdèfɔ̀
ìfèéfèé|ìfèéfèé
ìfé|ìfé
ìfìdíkalẹ̀|ìfìdíkalɛ̀
ìfìfẹ́|ìfìfɛ́
ìfìmọ̀ṣọ̀kan|ìfìmɔ̀ʃɔ̀kan
ìfòróróyàn|ìfòrórójàn
ìfòyà|ìfòjà
ìfófó|ìfófó
ìfúnilófin|ìfúnilófĩ
ìfúnni|ìfúnni
ìfúnpá|ìfúnk͡pá
ìfúnrúgbìn|ìfúnrúɡ͡bìn
ìfúntí|ìfúntí
ìfẹ|ìfɛ
ìfẹnukonu|ìfɛ̃ukonu
ìfẹsẹ̀múlẹ̀|ìfɛsɛ̀múlɛ̀
ìfẹ̀gbẹ́|ìfɛ̀ɡ͡bɛ́
ìfẹ̀sẹ̀|ìfɛ̀sɛ̀
ìfẹ̀tànṣe|ìfɛ̀tànʃe
ìfẹ́|ìfɛ́
ìfẹ́kúfẹ̀|ìfɛ́kúfɛ̀
ìfẹ́kúfẹ̀ẹ́|ìfɛ́kúfɛ̀ɛ́
ìfẹ́lódùn|ìfɛ́lódùn
ìfẹ́ni|ìfɛ́ni
ìfẹ́nukonu|ìfɛ́nukonu
ìfọkànbalẹ̀|ìfɔkànbalɛ̀
ìfọkàntán|ìfɔkàntán
ìfọnná|ìfɔ̃ná
ìfọ̀kànbalẹ̀|ìfɔ̀kànbalɛ̀
ìfọ́jú|ìfɔ́d͡ʒú
ìfọ́nnu|ìfɔ́nnu
ìfọ́tí|ìfɔ́tí
ìgalà|ìɡalà
ìgba|ìɡ͡ba
ìgbafẹ́|ìɡ͡bafɛ́
ìgbaniníyànjú|ìɡ͡banĩíjànd͡ʒú
ìgbanisíṣẹ́|ìɡ͡banisíʃɛ́
ìgbokùn|ìɡ͡bokùn
ìgboro|ìɡ͡boro
ìgboyà|ìɡ͡bojà
ìgbà|ìɡ͡bà
ìgbàanì|ìɡ͡bàanì
ìgbàgbọ́|ìɡ͡bàɡ͡bɔ́
ìgbàjá|ìɡ͡bàd͡ʒá
ìgbàkúgbà|ìɡ͡bàkúɡ͡bà
ìgbàlejò|ìɡ͡bàled͡ʒò
ìgbàlà|ìɡ͡bàlà
ìgbànú|ìɡ͡bànú
ìgbàyà|ìɡ͡bàjà
ìgbàyí|ìɡ͡bàjí
ìgbá|ìɡ͡bá
ìgbádùn|ìɡ͡bádùn
ìgbáfẹ́|ìɡ͡báfɛ́
ìgbákọ|ìɡ͡bákɔ
ìgbálẹ̀|ìɡ͡bálɛ̀
ìgbèkùn|ìɡ͡bèkùn
ìgbèríko|ìɡ͡bèríko
ìgbé|ìɡ͡bé
ìgbéga|ìɡ͡béɡa
ìgbékalẹ̀|ìɡ͡békalɛ̀
ìgbéraga|ìɡ͡béraɡa
ìgbéró|ìɡ͡béró
ìgbésí|ìɡ͡bésí
ìgbésẹ̀|ìɡ͡bésɛ̀
ìgbéyàwó|ìɡ͡béjàwó
ìgbì|ìɡ͡bì
ìgbìmọ̀|ìɡ͡bìmɔ̀
ìgbìyànjú|ìɡ͡bìjànd͡ʒú
ìgbín|ìɡ͡bín
ìgbò|ìɡ͡bò
ìgbógunti|ìɡ͡bóɡũti
ìgbóná|ìɡ͡bóná
ìgbónára|ìɡ͡bónára
ìgbóríyìn|ìɡ͡bóríjìn
ìgbóórùn|ìɡ͡bóórùn
ìgbẹ̀san|ìɡ͡bɛ̀san
ìgbẹ̀yin|ìɡ͡bɛ̀jĩ
ìgbẹ̀yìn|ìɡ͡bɛ̀jìn
ìgbẹ́|ìɡ͡bɛ́
ìgbẹ́jọ́|ìɡ͡bɛ́d͡ʒɔ́
ìgbẹ́kẹ̀lé|ìɡ͡bɛ́kɛ̀lé
ìgbẹ́sẹ̀|ìɡ͡bɛ́sɛ̀
ìgbọràn|ìɡ͡bɔràn
ìgbọ̀nsẹ̀|ìɡ͡bɔ̀nsɛ̀
ìgbọ̀nwọ́|ìɡ͡bɔ̀nwɔ́
ìgbọ̀ǹsẹ̀|ìɡ͡bɔ̀ǹsɛ̀
ìgbọ́|ìɡ͡bɔ́
ìgbọ́kùgbọ̀ọ́|ìɡ͡bɔ́kùɡ͡bɔ̀ɔ́
ìgbọ́ran|ìɡ͡bɔ́ran
ìgbọ́ràn|ìɡ͡bɔ́ràn
ìgbọ́wọ́|ìɡ͡bɔ́wɔ́
ìgbọ́wọ́lé|ìɡ͡bɔ́wɔ́lé
ìgbọ́wọ́sókè|ìɡ͡bɔ́wɔ́sókè
ìgunnu|ìɡũnu
ìgà|ìɡà
ìgárá|ìɡárá
ìgéraga|ìɡéraɡa
ìgò|ìɡò
ìgòkè|ìɡòkè
ìgúnu|ìɡúnu
ìgúnwà|ìɡúnwà
ìhalẹ̀|ìhalɛ̀
ìhà|ìhà
ìhàlẹ̀|ìhàlɛ̀
ìhámọ́|ìhámɔ́
ìhámọ́ra|ìhámɔ́ra
ìhín|ìhín
ìhòhò|ìhòhò
ìhòhòèmi|ìhòhòèmi
ìhó|ìhó
ìhùwàsí|ìhùwàsí
ìjayà|ìd͡ʒajà
ìje|ìd͡ʒe
ìjiyàn|ìd͡ʒijàn
ìjogún|ìd͡ʒoɡún
ìjowú|ìd͡ʒowú
ìjà|ìd͡ʒà
ìjàkadì|ìd͡ʒàkadì
ìjàkùmọ̀|ìd͡ʒàkùmɔ̀
ìjàm̀bá|ìd͡ʒàm̀bá
ìjàpá|ìd͡ʒàk͡pá
ìjàǹbá|ìd͡ʒàǹbá
ìjá|ìd͡ʒá
ìjáde|ìd͡ʒáde
ìjáfara|ìd͡ʒáfara
ìjákulẹ̀|ìd͡ʒákulɛ̀
ìjánu|ìd͡ʒánu
ìjì|ìd͡ʒì
ìjìká|ìd͡ʒìká
ìjìnlẹ̀|ìd͡ʒìnlɛ̀
ìjìyà|ìd͡ʒìjà
ìjí|ìd͡ʒí
ìjíròrò|ìd͡ʒíròrò
ìjòyè|ìd͡ʒòjè
ìjó|ìd͡ʒó
ìjóko|ìd͡ʒóko
ìjókòó|ìd͡ʒókòó
ìjóni|ìd͡ʒóni
ìjóná|ìd͡ʒóná
ìjẹ|ìd͡ʒɛ
ìjẹgàba|ìd͡ʒɛɡàba
ìjẹkújẹ|ìd͡ʒɛkúd͡ʒɛ
ìjẹrin|ìd͡ʒɛrĩ
ìjẹrìnlá|ìd͡ʒɛrìnlá
ìjẹta|ìd͡ʒɛta
ìjẹun|ìd͡ʒɛũ
ìjẹyọ|ìd͡ʒɛjɔ
ìjẹ̀bi|ìd͡ʒɛ̀bi
ìjẹ̀bú|ìd͡ʒɛ̀bú
ìjẹ̀ṣa|ìd͡ʒɛ̀ʃa
ìjẹ́|ìd͡ʒɛ́
ìjẹ́jọ́|ìd͡ʒɛ́d͡ʒɔ́
ìjẹ́ni|ìd͡ʒɛ́ni
ìjẹ́rin|ìd͡ʒɛ́rĩ
ìjẹ́rìí|ìd͡ʒɛ́rìí
ìjẹ́wọ́|ìd͡ʒɛ́wɔ́
ìjẹẹ̀ta|ìd͡ʒɛɛ̀ta
ìjọ|ìd͡ʒɔ
ìjọba|ìd͡ʒɔba
ìjọbakíjọba|ìd͡ʒɔbakíd͡ʒɔba
ìjọsìn|ìd͡ʒɔsìn
ìjọ̀gbọ̀n|ìd͡ʒɔ̀ɡ͡bɔ̀n
ìjọ́sìn|ìd͡ʒɔ́sìn
ìka|ìka
ìkan|ìkan
ìkangun|ìkanɡũ
ìkanra|ìkanra
ìkejà|ìked͡ʒà
ìkejì|ìked͡ʒì
ìkookò|ìkookò
ìkorò|ìkorò
ìkunra|ìkũra
ìkà|ìkà
ìkàánú|ìkàánú
ìkángun|ìkánɡũ
ìkánjú|ìkánd͡ʒú
ìkápá|ìkák͡pá
ìkáwọ́|ìkáwɔ́
ìkáwọ́gbera|ìkáwɔ́ɡ͡bera
ìkáyà|ìkájà
ìkáàánú|ìkáàánú
ìkáṣọsí|ìkáʃɔsí
ìkélé|ìkélé
ìkérora|ìkérora
ìkìlò|ìkìlò
ìkìlọ̀|ìkìlɔ̀
ìkíni|ìkíni
ìkírè|ìkírè
ìkòkò|ìkòkò
ìkòròdú|ìkòròdú
ìkòyí|ìkòjí
ìkó|ìkó
ìkógun|ìkóɡũ
ìkójọ|ìkód͡ʒɔ
ìkójọpọ̀|ìkód͡ʒɔk͡pɔ̀
ìkókó|ìkókó
ìkólẹ̀|ìkólɛ̀
ìkólọ|ìkólɔ
ìkómọ|ìkómɔ
ìkóra|ìkóra
ìkórajọ|ìkórad͡ʒɔ
ìkórè|ìkórè
ìkórìíra|ìkórìíra
ìkóríta|ìkóríta
ìkùnsínú|ìkùnsínú
ìkùùkuu|ìkùùkuu
ìkún|ìkún
ìkúnlẹ̀|ìkúnlɛ̀
ìkẹta|ìkɛta
ìkẹyìn|ìkɛjìn
ìkẹ́|ìkɛ́
ìkẹ́kùn|ìkɛ́kùn
ìkẹ́ra|ìkɛ́ra
ìkọ|ìkɔ
ìkọjá|ìkɔd͡ʒá
ìkọlà|ìkɔlà
ìkọta|ìkɔta
ìkọ̀|ìkɔ̀
ìkọ̀kọ̀|ìkɔ̀kɔ̀
ìkọ̀sílẹ̀|ìkɔ̀sílɛ̀
ìkọ̀sẹ̀|ìkɔ̀sɛ̀
ìkọ̀ta|ìkɔ̀ta
ìkọ̀tún|ìkɔ̀tún
ìkọ̀wé|ìkɔ̀wé
ìkọ́|ìkɔ́
ìkọ́jàsí|ìkɔ́d͡ʒàsí
ìkọ́ni|ìkɔ́ni
ìkọ́ṣẹ́|ìkɔ́ʃɛ́
ìlara|ìlara
ìlawọ́|ìlawɔ́
ìlekè|ìlekè
ìlera|ìlera
ìlera’|ìlera’
ìletò|ìletò
ìletòkíletò|ìletòkíletò
ìloro|ìloro
ìlu|ìlu
ìlà|ìlà
ìlàjà|ìlàd͡ʒà
ìlànà|ìlànà
ìlé|ìlé
ìlépa|ìlék͡pa
ìléru|ìléru
ìlérí|ìlérí
ìléròrò|ìléròrò
ìlò|ìlò
ìlòdì|ìlòdì
ìlù|ìlù
ìlú|ìlú
ìlúbìnrin|ìlúbìnrĩ
ìlúkílùú|ìlúkílùú
ìlúmọ̀ọ́ká|ìlúmɔ̀ɔ́ká
ìlúu|ìlúu
ìlẹ̀dú|ìlɛ̀dú
ìlẹ̀kùn|ìlɛ̀kùn
ìlẹ̀kẹ̀|ìlɛ̀kɛ̀
ìlọrin|ìlɔrĩ
ìlọsíwájú|ìlɔsíwád͡ʒú
ìlọ́lọ́rùnpa|ìlɔ́lɔ́rùnk͡pa
ìlọ́nilọ́wọ́gbà|ìlɔ́nilɔ́wɔ́ɡ͡bà
ìlọ́po|ìlɔ́k͡po
ìlọṣọ|ìlɔʃɔ
ìmele|ìmele
ìmoore|ìmoore
ìmutípara|ìmutík͡para
ìmí|ìmí
ìmísí|ìmísí
ìmòye|ìmòje
ìmú|ìmú
ìmúdàgbà|ìmúdàɡ͡bà
ìmúdúró|ìmúdúró
ìmúdọ́gba|ìmúdɔ́ɡ͡ba
ìmúkúrò|ìmúkúrò
ìmúláradá|ìmúláradá
ìmúláyàle|ìmúlájàle
ìmúlọ́kànle|ìmúlɔ́kànle
ìmúni|ìmúni
ìmúniṣìnà|ìmúniʃìnà
ìmúnríran|ìmúnríran
ìmúná|ìmúná
ìmúpadà|ìmúk͡padà
ìmúra|ìmúra
ìmúrasílẹ̀|ìmúrasílɛ̀
ìmúraṣíṣẹ́|ìmúraʃíʃɛ́
ìmúwòdù|ìmúwòdù
ìmúṣẹ|ìmúʃɛ
ìmẹ́lẹ́|ìmɛ́lɛ́
ìmọ|ìmɔ
ìmọ̀|ìmɔ̀
ìmọ̀nàmọ́ná|ìmɔ̀nàmɔ́ná
ìmọ̀ràn|ìmɔ̀ràn
ìmọ̀tẹ́lẹ̀|ìmɔ̀tɛ́lɛ̀
ìmọ́kànle|ìmɔ́kànle
ìmọ́lẹ̀|ìmɔ́lɛ̀
ìmọ́tótó|ìmɔ́tótó
ìn|ìn
ìnilára|ìnilára
ìninilára|ìnĩilára
ìnira|ìnira
ìnura|ìnura
ìnuwọ́|ìnuwɔ́
ìnà|ìnà
ìnàkí|ìnàkí
ìnàsílẹ̀|ìnàsílɛ̀
ìnákúnàá|ìnákúnàá
ìnáwó|ìnáwó
ìní|ìní
ìníolúwa|ìníolúwa
ìpa|ìk͡pa
ìpadà|ìk͡padà
ìpadàbọ̀|ìk͡padàbɔ̀
ìpadàsẹ́yìn|ìk͡padàsɛ́jìn
ìpakà|ìk͡pakà
ìpakúpa|ìk͡pakúk͡pa
ìpalára|ìk͡palára
ìpalẹ̀mọ́|ìk͡palɛ̀mɔ́
ìpamọ́|ìk͡pamɔ́
ìpamọ́ra|ìk͡pamɔ́ra
ìpani|ìk͡pani
ìpanu|ìk͡panu
ìpara|ìk͡para
ìparadà|ìk͡paradà
ìparun|ìk͡parũ
ìparí|ìk͡parí
ìparọ́rọ́|ìk͡parɔ́rɔ́
ìpayà|ìk͡pajà
ìpayínkeke|ìk͡pajínkeke
ìpaà|ìk͡paà
ìpele|ìk͡pele
ìpilẹ̀ṣẹ̀|ìk͡pilɛ̀ʃɛ̀
ìpinnu|ìk͡pĩnu
ìpinyà|ìk͡pĩjà
ìpohùnréré|ìk͡pohùnréré
ìpolongo|ìk͡polonɡo
ìpolówó|ìk͡polówó
ìpàdé|ìk͡pàdé
ìpàgọ́|ìk͡pàɡɔ́
ìpànìyàn|ìk͡pànìjàn
ìpààrọ̀|ìk͡pààrɔ̀
ìpàṣẹ|ìk͡pàʃɛ
ìpáàrà|ìk͡páàrà
ìpè|ìk͡pè
ìpèníjà|ìk͡pèníd͡ʒà
ìpèsè|ìk͡pèsè
ìpéjọ|ìk͡péd͡ʒɔ
ìpéjọpọ̀|ìk͡péd͡ʒɔk͡pɔ̀
ìpìlẹ̀|ìk͡pìlɛ̀
ìpín|ìk͡pín
ìpínlẹ̀|ìk͡pínlɛ̀
ìpòrúru|ìk͡pòrúru
ìpòùngbẹ|ìk͡pòùnɡ͡bɛ
ìpẹja|ìk͡pɛd͡ʒa
ìpẹ̀kun|ìk͡pɛ̀kũ
ìpẹ́|ìk͡pɛ́
ìpọnmi|ìk͡pɔ̃mi
ìpọntí|ìk͡pɔ̃tí
ìpọ̀sí|ìk͡pɔ̀sí
ìpọ́njú|ìk͡pɔ́nd͡ʒú
ìpọ́nni|ìk͡pɔ́nni
ìran|ìran
ìrandíran|ìrandíran
ìre|ìre
ìrora|ìrora
ìrun|ìrũ
ìrunú|ìrũú
ìrànlọ́wọ́|ìrànlɔ́wɔ́
ìrànrán|ìrànrán
ìrànwọ́|ìrànwɔ́
ìràpadà|ìràk͡padà
ìràwọ̀|ìràwɔ̀
ìrántí|ìrántí
ìránṣẹ́|ìránʃɛ́
ìránṣẹ́bìnrin|ìránʃɛ́bìnrĩ
ìránṣẹ́kùnrin|ìránʃɛ́kùnrĩ
ìrè|ìrè
ìrèké|ìrèké
ìrèmọ̀jé|ìrèmɔ̀d͡ʒé
ìrèmọ̀jẹ́|ìrèmɔ̀d͡ʒɛ́
ìrèti|ìrèti
ìrètí|ìrètí
ìré|ìré
ìréde|ìréde
ìrékọjá|ìrékɔd͡ʒá
ìrémọjẹ|ìrémɔd͡ʒɛ
ìrépé|ìrék͡pé
ìrì|ìrì
ìrìbọmi|ìrìbɔmi
ìrìn|ìrìn
ìrìnàjò|ìrìnàd͡ʒò
ìrí|ìrí
ìríjú|ìríd͡ʒú
ìrínisí|ìrínisí
ìríra|ìríra
ìríran|ìríran
ìríran’|ìríran’
ìrírí|ìrírí
ìrísí|ìrísí
ìrò|ìrò
ìròbìnújẹ́|ìròbìnúd͡ʒɛ́
ìrònú|ìrònú
ìrònúpìwàdà|ìrònúk͡pìwàdà
ìròyìn|ìròjìn
ìró|ìró
ìrù|ìrù
ìrú|ìrú
ìrúbọ|ìrúbɔ
ìrúfin|ìrúfĩ
ìrúkèrúdò|ìrúkèrúdò
ìrẹsì|ìrɛsì
ìrẹ̀|ìrɛ̀
ìrẹ̀dànù|ìrɛ̀dànù
ìrẹ̀l|ìrɛ̀l
ìrẹ̀lẹ̀|ìrɛ̀lɛ̀
ìrẹ̀lẹ́|ìrɛ̀lɛ́
ìrẹ̀sílẹ̀|ìrɛ̀sílɛ̀
ìrẹ̀tẹ̀|ìrɛ̀tɛ̀
ìrẹ̀wẹ̀sì|ìrɛ̀wɛ̀sì
ìrẹ́jẹ|ìrɛ́d͡ʒɛ
ìrẹ́pọ̀|ìrɛ́k͡pɔ̀
ìrẹ́pọ̀ọ́dùn|ìrɛ́k͡pɔ̀ɔ́dùn
ìrọbí|ìrɔbí
ìrọ̀lẹ́|ìrɔ̀lɛ́
ìrọ̀rí|ìrɔ̀rí
ìrọ̀rùn|ìrɔ̀rùn
ìrọ́kẹ̀kẹ̀|ìrɔ́kɛ̀kɛ̀
ìsanwó|ìsanwó
ìsimi|ìsimi
ìsin|ìsĩ
ìsinmi|ìsĩmi
ìsinsin|ìsĩsĩ
ìso|ìso
ìsokùn|ìsokùn
ìsolù|ìsolù
ìsopọ̀|ìsok͡pɔ̀
ìsun|ìsũ
ìsunjáde|ìsũd͡ʒáde
ìsàlè|ìsàlè
ìsàlẹ̀|ìsàlɛ̀
ìsádi|ìsádi
ìsáǹsá|ìsáǹsá
ìsèkúsè|ìsèkúsè
ìsìlàmíyà|ìsìlàmíjà
ìsìlámù|ìsìlámù
ìsìn|ìsìn
ìsìnkú|ìsìnkú
ìsìnrú|ìsìnrú
ìsìnyín|ìsìnjín
ìsínwín|ìsínwín
ìsíyìín|ìsíjìín
ìsẹ̀yín|ìsɛ̀jín
ìsẹ́ra|ìsɛ́ra
ìsẹ́yìn|ìsɛ́jìn
ìsọ|ìsɔ
ìsọdahoro|ìsɔdahoro
ìsọdimímọ́|ìsɔdimímɔ́
ìsọdá|ìsɔdá
ìsọdọmọ|ìsɔdɔmɔ
ìsọdọ̀tun|ìsɔdɔ̀tũ
ìsọkúsọ|ìsɔkúsɔ
ìsọlẹ́nu|ìsɔlɛ́nu
ìsọnidààyè|ìsɔ̃idààjè
ìsọtẹ́lẹ̀|ìsɔtɛ́lɛ̀
ìsọ̀kan|ìsɔ̀kan
ìsọ̀rí|ìsɔ̀rí
ìsọ̀rọ̀|ìsɔ̀rɔ̀
ìta|ìta
ìtafà|ìtafà
ìtajà|ìtad͡ʒà
ìtakò|ìtakò
ìtakùrọ̀sọ|ìtakùrɔ̀sɔ
ìtan|ìtan
ìtanù|ìtanù
ìtara|ìtara
ìtasórí|ìtasórí
ìtayọ|ìtajɔ
ìtaṣe|ìtaʃe
ìtulẹ̀|ìtulɛ̀
ìtumọ̀|ìtumɔ̀
ìtura|ìtura
ìtàgé|ìtàɡé
ìtàjẹ̀|ìtàd͡ʒɛ̀
ìtàn|ìtàn
ìtànjẹ|ìtànd͡ʒɛ
ìtànná|ìtànná
ìtànṣán|ìtànʃán
ìtàsẹ́|ìtàsɛ́
ìtán|ìtán
ìtánràn|ìtánràn
ìtì|ìtì
ìtìjú|ìtìd͡ʒú
ìtìlẹ̀|ìtìlɛ̀
ìtìsẹ̀|ìtìsɛ̀
ìtí|ìtí
ìtòsí|ìtòsí
ìtójú|ìtód͡ʒú
ìtùnú|ìtùnú
ìtújáde|ìtúd͡ʒáde
ìtúmọ̀|ìtúmɔ̀
ìtúsílẹ̀|ìtúsílɛ̀
ìtẹnumọ́|ìtɛ̃umɔ́
ìtẹríba|ìtɛríba
ìtẹ̀bọmi|ìtɛ̀bɔmi
ìtẹ̀bọ̀|ìtɛ̀bɔ̀
ìtẹ̀lẹ̀|ìtɛ̀lɛ̀
ìtẹ̀mọ́lẹ̀|ìtɛ̀mɔ́lɛ̀
ìtẹ̀síwájú|ìtɛ̀síwád͡ʒú
ìtẹ̀wọ̀n|ìtɛ̀wɔ̀n
ìtẹ́|ìtɛ́
ìtẹ́lọ́rùn|ìtɛ́lɔ́rùn
ìtẹ́wọ́gbà|ìtɛ́wɔ́ɡ͡bà
ìtọrẹ|ìtɔrɛ
ìtọ̀|ìtɔ̀
ìtọ́|ìtɔ́
ìtọ́jú|ìtɔ́d͡ʒú
ìtọ́kọ̀|ìtɔ́kɔ̀
ìtọ́ni|ìtɔ́ni
ìtọ́sọ́nà|ìtɔ́sɔ́nà
ìwo|ìwo
ìwà|ìwà
ìwàkiwà|ìwàkiwà
ìwàláàyè|ìwàláàjè
ìwàlọlá|ìwàlɔlá
ìwàyáàjà|ìwàjáàd͡ʒà
ìwàásù|ìwàásù
ìwádi|ìwádi
ìwádìí|ìwádìí
ìwárìrì|ìwárìrì
ìwásẹ̀|ìwásɛ̀
ìwé|ìwé
ìwée|ìwée
ìwò|ìwò
ìwòsàn|ìwòsàn
ìwòyí|ìwòjí
ìwúkàrà|ìwúkàrà
ìwúrì|ìwúrì
ìwúrí|ìwúrí
ìwúwo|ìwúwo
ìwẹ̀|ìwɛ̀
ìwẹ̀fà|ìwɛ̀fà
ìwẹ̀nù|ìwɛ̀nù
ìwẹ̀nùmọ́|ìwɛ̀nùmɔ́
ìwọ|ìwɔ
ìwọdò|ìwɔdò
ìwọra|ìwɔra
ìwọ̀|ìwɔ̀
ìwọ̀fà|ìwɔ̀fà
ìwọ̀n|ìwɔ̀n
ìwọ̀nba|ìwɔ̀nba
ìwọ̀ntúnwọ̀nsì|ìwɔ̀ntúnwɔ̀nsì
ìwọ̀nyí|ìwɔ̀njí
ìwọ̀sí|ìwɔ̀sí
ìwọ̀ǹba|ìwɔ̀ǹba
ìwọ́|ìwɔ́
ìwọ́jọpọ̀|ìwɔ́d͡ʒɔk͡pɔ̀
ìya|ìja
ìyakọ|ìjakɔ
ìyanu|ìjanu
ìyanu’|ìjanu’
ìyanṣẹ́lódì|ìjanʃɛ́lódì
ìyapa|ìjak͡pa
ìyekan|ìjekan
ìyekàn|ìjekàn
ìyà|ìjà
ìyàlẹ́nu|ìjàlɛ́nu
ìyàn|ìjàn
ìyànfẹ́|ìjànfɛ́
ìyàngbò|ìjànɡ͡bò
ìyàngbẹ|ìjànɡ͡bɛ
ìyànjú|ìjànd͡ʒú
ìyànà|ìjànà
ìyàsímímọ́|ìjàsímímɔ́
ìyàsọ́tọ̀|ìjàsɔ́tɔ̀
ìyàtọ̀|ìjàtɔ̀
ìyàwó|ìjàwó
ìyàwóò|ìjàwóò
ìyá|ìjá
ìyábọ̀|ìjábɔ̀
ìyálé|ìjálé
ìyálẹ̀ta|ìjálɛ̀ta
ìyálọ́jà|ìjálɔ́d͡ʒà
ìyániẃurà|ìjániẃurà
ìyára|ìjára
ìyè|ìjè
ìyè’|ìjè’
ìyékan|ìjékan
ìyìn|ìjìn
ìyìnrere|ìjìnrere
ìyìnreretí|ìjìnreretí
ìyín|ìjín
ìyípadà|ìjík͡padà
ìyókù|ìjókù
ìyówù|ìjówù
ìyẹn|ìjɛ̃
ìyẹ̀fun|ìjɛ̀fũ
ìyẹ̀wù|ìjɛ̀wù
ìyẹ́|ìjɛ́
ìyẹ́ka|ìjɛ́ka
ìyọnu|ìjɔ̃u
ìyọrísí|ìjɔrísí
ìyọ̀ǹda|ìjɔ̀ǹda
ìyọ́nú|ìjɔ́nú
ìyọṣùtì|ìjɔʃùtì
ìṕinlẹ̀|ìk͡ṕĩlɛ̀
ìṣasùn|ìʃasùn
ìṣe|ìʃe
ìṣeféfé|ìʃeféfé
ìṣekúṣe|ìʃekúʃe
ìṣeré|ìʃeré
ìṣesí|ìʃesí
ìṣeun|ìʃeũ
ìṣeyèméjì|ìʃejèméd͡ʒì
ìṣirò|ìʃirò
ìṣiwèrè|ìʃiwèrè
ìṣoore|ìʃoore
ìṣoṣó|ìʃoʃó
ìṣubú|ìʃubú
ìṣàfihàn|ìʃàfihàn
ìṣàkóso|ìʃàkóso
ìṣàn|ìʃàn
ìṣàyẹ̀wò|ìʃàjɛ̀wò
ìṣáájú|ìʃáád͡ʒú
ìṣáájú’|ìʃáád͡ʒú’
ìṣègùn|ìʃèɡùn
ìṣèjọba|ìʃèd͡ʒɔba
ìṣèkúṣè|ìʃèkúʃè
ìṣìnà|ìʃìnà
ìṣíkọ̀|ìʃíkɔ̀
ìṣínípò|ìʃíník͡pò
ìṣípa|ìʃík͡pa
ìṣípayá|ìʃík͡pajá
ìṣípá|ìʃík͡pá
ìṣípò|ìʃík͡pò
ìṣísẹ̀|ìʃísɛ̀
ìṣíwájú|ìʃíwád͡ʒú
ìṣòdodo|ìʃòdodo
ìṣòfo|ìʃòfo
ìṣògo|ìʃòɡo
ìṣòro|ìʃòro
ìṣòtítọ́|ìʃòtítɔ́
ìṣòwò|ìʃòwò
ìṣó|ìʃó
ìṣù|ìʃù
ìṣúdudu|ìʃúdudu
ìṣúra|ìʃúra
ìṣẹri|ìʃɛri
ìṣẹ̀dá|ìʃɛ̀dá
ìṣẹ̀fẹ̀|ìʃɛ̀fɛ̀
ìṣẹ̀lẹ̀|ìʃɛ̀lɛ̀
ìṣẹ̀yìn|ìʃɛ̀jìn
ìṣẹ̀yín|ìʃɛ̀jín
ìṣẹ́|ìʃɛ́
ìṣẹ́gun|ìʃɛ́ɡũ
ìṣẹ́jú|ìʃɛ́d͡ʒú
ìṣẹ́pẹ́|ìʃɛ́k͡pɛ́
ìṣẹ́ri|ìʃɛ́ri
ìṣẹ́tí|ìʃɛ́tí
ìṣọ̀|ìʃɔ̀
ìṣọ̀fọ̀|ìʃɔ̀fɔ̀
ìṣọ̀kan|ìʃɔ̀kan
ìṣọ̀rọ̀|ìʃɔ̀rɔ̀
ìṣọ̀tá|ìʃɔ̀tá
ìṣọ̀tẹ̀|ìʃɔ̀tɛ̀
ìṣọ́|ìʃɔ́
ìṣọ́ra|ìʃɔ́ra
í|í
ín|ín
ín’|ín’
ísírẹ́lì|ísírɛ́lì
ò|ò
òbu|òbu
òbí|òbí
òbírí|òbírí
òbúkọ|òbúkɔ
òdaràn|òdaràn
òde|òde
òdo|òdo
òdodo|òdodo
òdì|òdì
òdìkejì|òdìked͡ʒì
òdòdó|òdòdó
òfin|òfĩ
òfinràn|òfĩràn
òfo|òfo
òfurufú|òfurufú
òfì|òfì
òfìfo|òfìfo
òfò|òfò
òfófó|òfófó
òfúrufú|òfúrufú
ògboyà|òɡ͡bojà
ògbufọ̀|òɡ͡bufɔ̀
ògbójú|òɡ͡bód͡ʒú
ògbólógbòó|òɡ͡bólóɡ͡bòó
ògbóǹtarìgì|òɡ͡bóǹtarìɡì
ògiri|òɡiri
ògo|òɡo
ògèdèǹgbé|òɡèdèǹɡ͡bé
ògì|òɡì
ògùn|òɡùn
ògùsọ̀|òɡùsɔ̀
ògùṣọ̀|òɡùʃɔ̀
ògún|òɡún
ògúndípẹ̀|òɡúndík͡pɛ̀
ògúnlàjà|òɡúnlàd͡ʒà
ògúnlájà|òɡúnlád͡ʒà
ògúnlèsì|òɡúnlèsì
ògúnlésì|òɡúnlésì
ògúntádé|òɡúntádé
òhun|òhũ
òhún|òhún
òjijì|òd͡ʒid͡ʒì
òjo|òd͡ʒo
òjìji|òd͡ʒìd͡ʒi
òjìá|òd͡ʒìá
òjíṣẹ́|òd͡ʒíʃɛ́
òjò|òd͡ʒò
òjòwú|òd͡ʒòwú
òjó|òd͡ʒó
òku|òku
òkun|òkũ
òkun’|òkũ’
òkuta|òkuta
òkè|òkè
òkèfúnwa|òkèfúnwa
òkèfúnwá|òkèfúnwá
òkèjọbí|òkèd͡ʒɔbí
òkèlè|òkèlè
òkèrè|òkèrè
òkèèrè|òkèèrè
òkédìjí|òkédìd͡ʒí
òkìkí|òkìkí
òkìtì|òkìtì
òkìtìpupa|òkìtìk͡puk͡pa
òkò|òkò
òkòtò|òkòtò
òkòtó|òkòtó
òkùnkùn|òkùnkùn
òkú|òkú
òkúndùn|òkúndùn
òkúta|òkúta
òkúta’|òkúta’
òkúàti|òkúàti
òmìnira|òmìnira
òmìnira’|òmìnira’
òmíràn|òmíràn
òmùgọ̀|òmùɡɔ̀
òmùwẹ̀|òmùwɛ̀
òn|òn
òní|òní
òpin|òk͡pĩ
òpè|òk͡pè
òpó|òk͡pó
òpópó|òk͡pók͡pó
òpópónà|òk͡pók͡pónà
òpùrọ́|òk͡pùrɔ́
òpẹ́bí|òk͡pɛ́bí
òru|òru
òrìsà|òrìsà
òrìṣa|òrìʃa
òrìṣà|òrìʃà
òrìṣàkórìṣà|òrìʃàkórìʃà
òrí|òrí
òróró|òróró
òróǹró|òróǹró
òrùka|òrùka
òrùlé|òrùlé
òrùngbẹ|òrùnɡ͡bɛ
òsì|òsì
òsùwọ̀n|òsùwɔ̀n
òtítọ́|òtítɔ́
òtòṣì|òtòʃì
òtútù|òtútù
òun|òũ
òun’|òũ’
òwe|òwe
òwìwí|òwìwí
òwò|òwò
òwú|òwú
òwúrọ|òwúrɔ
òwúrọ̀|òwúrɔ̀
òye|òje
òyì|òjì
òyìnbó|òjìnbó
òògbé|òòɡ͡bé
òògùn|òòɡùn
òòjọ́|òòd͡ʒɔ́
òòkùn|òòkùn
òòlù|òòlù
òòrùn|òòrùn
òòyà|òòjà
òòṣà|òòʃà
òógùn|òóɡùn
òórùn|òórùn
òótọ́|òótɔ́
òùngbẹ|òùnɡ͡bɛ
òún|òún
òǹdè|òǹdè
òǹdó|òǹdó
òǹgbẹ|òǹɡ͡bɛ
òǹkà|òǹkà
òǹkọ̀wé|òǹkɔ̀wé
òǹrorò|òǹrorò
òṣogbo|òʃoɡ͡bo
òṣèlù|òʃèlù
òṣèlú|òʃèlú
òṣèrè|òʃèrè
òṣìṣé|òʃìʃé
òṣìṣẹ́|òʃìʃɛ́
òṣónú|òʃónú
òṣùbà|òʃùbà
òṣùmàrè|òʃùmàrè
òṣùpá|òʃùk͡pá
òṣùwọ̀n|òʃùwɔ̀n
òṣùṣú|òʃùʃú
ó|ó
óníkìsì|óníkìsì
óákù|óákù
óò|óò
óúnjẹ|óúnd͡ʒɛ
ó’|ó’
ó”|ó”
ù|ù
ú|ú
ún|ún
ún’|ún’
ĺọ́wọ́|ĺɔ́wɔ́
ń|ń
ńi|ńi
ńkọ́|ńkɔ́
ńlá|ńlá
ǹ|ǹ
ǹjẹ́|ǹd͡ʒɛ́
ǹkan|ǹkan
̀|̀
̀bi|̀bi
̀bùn|̀bùn
̀bẹ̀|̀bɛ̀
̀dá|̀dá
̀dógún|̀dóɡún
̀dọ̀|̀dɔ̀
̀dọ́mọdé|̀dɔ́mɔdé
̀dọ́mọkùnrin|̀dɔ́mɔkùnrĩ
̀fẹ́|̀fɛ́
̀gbin|̀ɡ͡bĩ
̀gbà|̀ɡ͡bà
̀gbìn|̀ɡ͡bìn
̀gbẹ̀gbẹ́|̀ɡ͡bɛ̀ɡ͡bɛ́
̀gbẹ́|̀ɡ͡bɛ́
̀gbọ́n|̀ɡ͡bɔ́n
̀gàn|̀ɡàn
̀gá|̀ɡá
̀gún|̀ɡún
̀gọ|̀ɡɔ
̀jẹ̀|̀d͡ʒɛ̀
̀jẹ́|̀d͡ʒɛ́
̀ka|̀ka
̀kalẹ̀|̀kalɛ̀
̀kan|̀kan
̀kankan|̀kankan
̀kejì|̀ked͡ʒì
̀kínní|̀kínní
̀kún|̀kún
̀kúnrẹ́rẹ́|̀kúnrɛ́rɛ́
̀kúnwọ́|̀kúnwɔ́
̀kẹ́|̀kɛ́
̀kọ̀|̀kɔ̀
̀kọ́|̀kɔ́
̀la|̀la
̀lé|̀lé
̀mí|̀mí
̀m’egbò|̀m’eɡ͡bò
̀nà|̀nà
̀pá|̀k͡pá
̀pọ̀|̀k͡pɔ̀
̀pọ̀lọpọ̀|̀k͡pɔ̀lɔk͡pɔ̀
̀pọ̀tọ́|̀k͡pɔ̀tɔ́
̀run|̀rũ
̀ràn|̀ràn
̀rá|̀rá
̀rí|̀rí
̀rín|̀rín
̀rù|̀rù
̀rùn|̀rùn
̀rún|̀rún
̀rẹ̀|̀rɛ̀
̀rẹ̀kẹ́|̀rɛ̀kɛ́
̀rẹ́|̀rɛ́
̀rọ̀|̀rɔ̀
̀san|̀san
̀sán|̀sán
̀sìn|̀sìn
̀sílẹ̀|̀sílɛ̀
̀sùn|̀sùn
̀tàn|̀tàn
̀tá|̀tá
̀tún|̀tún
̀tẹ̀|̀tɛ̀
̀tọ́|̀tɔ́
̀wé|̀wé
̀wù|̀wù
̀wẹ̀sì|̀wɛ̀sì
̀wọ̀|̀wɔ̀
̀wọ̀n|̀wɔ̀n
̀wọ́|̀wɔ́
̀wọ́n|̀wɔ́n
̀yin|̀jĩ
̀yà|̀jà
̀yìn|̀jìn
̀yín|̀jín
̀ṣẹ̀|̀ʃɛ̀
̀ṣẹ̀’|̀ʃɛ̀’
̀ṣọ́|̀ʃɔ́
̀’|̀’
́|́
́bi|́bi
́dógún|́dóɡún
́dún|́dún
́dọ|́dɔ
́dọ̀|́dɔ̀
́dọọdún|́dɔɔdún
́fín|́fín
́fẹ̀ẹ́|́fɛ̀ɛ́
́gbẹ́|́ɡ͡bɛ́
́gán|́ɡán
́gí|́ɡí
́hùn|́hùn
́jà|́d͡ʒà
́jọ́|́d͡ʒɔ́
́kankán|́kankán
́kàn|́kàn
́la|́la
́lá|́lá
́lẹ̀|́lɛ̀
́lọ́|́lɔ́
́n|́n
́nà|́nà
́pè|́k͡pè
́pópó|́k͡pók͡pó
́pọ̀|́k͡pɔ̀
́run|́rũ
́rìn|́rìn
́rùn|́rùn
́rẹ|́rɛ
́rẹ́|́rɛ́
́sọ́|́sɔ́
́tọ̀|́tɔ̀
́un|́ũ
́wálé|́wálé
́wọ|́wɔ
́wọ̀ọ̀wọ́|́wɔ̀ɔ̀wɔ́
́wọ́|́wɔ́
́ṣewà|́ʃewà
́ṣọ̀ọ́|́ʃɔ̀ɔ́
́ọ́|́ɔ́
̣sùgbọ́n|̣sùɡ͡bɔ́n
̣ìkókó|̣ìkókó
ṣ'ekú|ʃ'ekú
ṣa|ʃa
ṣaddai|ʃaddai
ṣadraki|ʃadraki
ṣadé|ʃadé
ṣafani|ʃafani
ṣafati|ʃafati
ṣagbe|ʃaɡ͡be
ṣagbára|ʃaɡ͡bára
ṣage|ʃaɡe
ṣaharaimu|ʃaharaimu
ṣahasuma|ʃahasuma
ṣaka|ʃaka
ṣakaṣaka|ʃakaʃaka
ṣakitiyan|ʃakitijan
ṣalali|ʃalali
ṣaleketi|ʃaleketi
ṣallumu|ʃallumu
ṣalluni|ʃallũi
ṣaláìní|ʃaláìní
ṣaláìsí|ʃaláìsí
ṣaléwá|ʃaléwá
ṣamma|ʃamma
ṣammai|ʃammai
ṣammua|ʃammua
ṣamotu|ʃamotu
ṣamọ̀nà|ʃamɔ̀nà
ṣan|ʃan
ṣaraimi|ʃaraimi
ṣaroni|ʃaroni
ṣayọ̀|ʃajɔ̀
ṣaápọn|ʃaák͡pɔ̃
ṣe|ʃe
ṣealitieli|ʃealitieli
ṣeani|ʃeani
ṣeba|ʃeba
ṣebaniah|ʃebaniah
ṣebeoni|ʃebeoni
ṣebna|ʃebna
ṣedeuri|ʃedeuri
ṣee|ʃee
ṣeferi|ʃeferi
ṣefoni|ʃefoni
ṣekaniah|ʃekaniah
ṣekemu|ʃekemu
ṣekí|ʃekí
ṣekú|ʃekú
ṣela|ʃela
ṣelemiah|ʃelemiah
ṣeliṣi|ʃeliʃi
ṣelomiti|ʃelomiti
ṣelomoti|ʃelomoti
ṣelumieli|ʃelumieli
ṣema|ʃema
ṣemaiah|ʃemaiah
ṣemeṣi|ʃemeʃi
ṣemida|ʃemida
ṣemu|ʃemu
ṣemí|ʃemí
ṣerebiah|ʃerebiah
ṣeré|ʃeré
ṣerépá|ʃerék͡pá
ṣetán|ʃetán
ṣetán’|ʃetán’
ṣeun|ʃeũ
ṣeé|ʃeé
ṣeéṣe|ʃeéʃe
ṣeṣai|ʃeʃai
ṣeṣaki|ʃeʃaki
ṣeṣani|ʃeʃani
ṣe’|ʃe’
ṣe’pò|ʃe’k͡pò
ṣiba|ʃiba
ṣihori|ʃihori
ṣilhimu|ʃilhimu
ṣilo|ʃilo
ṣimea|ʃimea
ṣimei|ʃimei
ṣimroni|ʃimroni
ṣimṣai|ʃimʃai
ṣinari|ʃĩari
ṣinṣin|ʃĩʃĩ
ṣiré|ʃiré
ṣisẹ́|ʃisɛ́
ṣittimu|ʃittimu
ṣiyèméjì|ʃijèméd͡ʒì
ṣiṣaki|ʃiʃaki
ṣiṣé|ʃiʃé
ṣiṣẹ̀|ʃiʃɛ̀
ṣiṣẹ́|ʃiʃɛ́
ṣo|ʃo
ṣoa|ʃoa
ṣobabu|ʃobabu
ṣobali|ʃobali
ṣogo|ʃoɡo
ṣojú|ʃod͡ʒú
ṣoko|ʃoko
ṣokùnfà|ʃokùnfà
ṣoo|ʃoo
ṣoore|ʃoore
ṣorí|ʃorí
ṣowọ́pọ̀|ʃowɔ́k͡pɔ̀
ṣoò|ʃoò
ṣoṣo|ʃoʃo
ṣu|ʃu
ṣua|ʃua
ṣubaeli|ʃubaeli
ṣubú|ʃubú
ṣubúọlá|ʃubúɔlá
ṣubúọ́lá|ʃubúɔ́lá
ṣufamu|ʃufamu
ṣuhi|ʃuhi
ṣumati|ʃumati
ṣunemu|ʃũemu
ṣuni|ʃũi
ṣuppimu|ʃuk͡pk͡pimu
ṣuri|ʃuri
ṣurieli|ʃurieli
ṣutelahi|ʃutelahi
ṣà|ʃà
ṣàbòsí|ʃàbòsí
ṣàdúà|ʃàdúà
ṣàfẹ́rí|ʃàfɛ́rí
ṣàjèjì|ʃàd͡ʒèd͡ʒì
ṣàjọ|ʃàd͡ʒɔ
ṣàkàṣàkà|ʃàkàʃàkà
ṣàkì|ʃàkì
ṣàkíyèsí|ʃàkíjèsí
ṣàkóso|ʃàkóso
ṣàlàyé|ʃàlàjé
ṣàn|ʃàn
ṣàngó|ʃànɡó
ṣàníyàn|ʃàníjàn
ṣàpèjú|ʃàk͡pèd͡ʒú
ṣàpèjúwe|ʃàk͡pèd͡ʒúwe
ṣàpẹẹrẹ|ʃàk͡pɛɛrɛ
ṣàpọ́n|ʃàk͡pɔ́n
ṣàròyé|ʃàròjé
ṣàtìpó|ʃàtìk͡pó
ṣàwàdà|ʃàwàdà
ṣàwárí|ʃàwárí
ṣàánú|ʃàánú
ṣàárẹ̀|ʃàárɛ̀
ṣàì|ʃàì
ṣàìbọ̀wọ̀|ʃàìbɔ̀wɔ̀
ṣàìgbé|ʃàìɡ͡bé
ṣàìjẹ|ʃàìd͡ʒɛ
ṣàìjẹ́rìí|ʃàìd͡ʒɛ́rìí
ṣàìmá|ʃàìmá
ṣàìrán|ʃàìrán
ṣàìsàn|ʃàìsàn
ṣàìṣẹ|ʃàìʃɛ
ṣàǹfààní|ʃàǹfààní
ṣá|ʃá
ṣágo|ʃáɡo
ṣáko|ʃáko
ṣákì|ʃákì
ṣáláńgá|ʃáláńɡá
ṣán|ʃán
ṣánlẹ̀|ʃánlɛ̀
ṣánṣán|ʃánʃán
ṣátá|ʃátá
ṣáájú|ʃáád͡ʒú
ṣáátá|ʃáátá
ṣáṣá|ʃáʃá
ṣè|ʃè
ṣèbà|ʃèbà
ṣègbé|ʃèɡ͡bé
ṣèké|ʃèké
ṣèlérí|ʃèlérí
ṣèrànwọ́|ʃèrànwɔ́
ṣèrántí|ʃèrántí
ṣètò|ʃètò
ṣètùtù|ʃètùtù
ṣèèṣì|ʃèèʃì
ṣèṣe|ʃèʃe
ṣèṣì|ʃèʃì
ṣèṣẹ̀|ʃèʃɛ̀
ṣè’jọ̀gbọ̀n|ʃè’d͡ʒɔ̀ɡ͡bɔ̀n
ṣé|ʃé
ṣékélì|ʃékélì
ṣépè|ʃék͡pè
ṣì|ʃì
ṣìkẹ́|ʃìkɛ́
ṣìnà|ʃìnà
ṣìná|ʃìná
ṣìpẹ̀|ʃìk͡pɛ̀
ṣí|ʃí
ṣíbí|ʃíbí
ṣídìí|ʃídìí
ṣígun|ʃíɡũ
ṣíkọ̀|ʃíkɔ̀
ṣílẹ̀kùn|ʃílɛ̀kùn
ṣípáyà|ʃík͡pájà
ṣírò|ʃírò
ṣís̀e|ʃís̀e
ṣísẹ̀|ʃísɛ̀
ṣíwọ́|ʃíwɔ́
ṣíṣe|ʃíʃe
ṣíṣàn|ʃíʃàn
ṣíṣí|ʃíʃí
ṣíṣògo|ʃíʃòɡo
ṣíṣẹ́|ʃíʃɛ́
ṣíṣọ́|ʃíʃɔ́
ṣòfin|ʃòfĩ
ṣòfò|ʃòfò
ṣòfófó|ʃòfófó
ṣògo|ʃòɡo
ṣòkòto|ʃòkòto
ṣòkòtò|ʃòkòtò
ṣòro|ʃòro
ṣòwò|ʃòwò
ṣófo|ʃófo
ṣókí|ʃókí
ṣókùnkùn|ʃókùnkùn
ṣóun|ʃóũ
ṣóyínká|ʃójínká
ṣóńṣó|ʃóńʃó
ṣù|ʃù
ṣùbòmí|ʃùbòmí
ṣùgbọ́|ʃùɡ͡bɔ́
ṣùgbọ́n|ʃùɡ͡bɔ́n
ṣùjọ|ʃùd͡ʒɔ
ṣùpọ̀|ʃùk͡pɔ̀
ṣùtì|ʃùtì
ṣú|ʃú
ṣúgà|ʃúɡà
ṣẹ|ʃɛ
ṣẹfíù|ʃɛfíù
ṣẹgbẹ́ẹ|ʃɛɡ͡bɛ́ɛ
ṣẹlẹ̀|ʃɛlɛ̀
ṣẹrù|ʃɛrù
ṣẹrú|ʃɛrú
ṣẹwẹlẹ|ʃɛwɛlɛ
ṣẹ̀|ʃɛ̀
ṣẹ̀dá|ʃɛ̀dá
ṣẹ̀fíù|ʃɛ̀fíù
ṣẹ̀fẹ̀|ʃɛ̀fɛ̀
ṣẹ̀kẹ̀rẹ̀|ʃɛ̀kɛ̀rɛ̀
ṣẹ̀rù|ʃɛ̀rù
ṣẹ̀sín|ʃɛ̀sín
ṣẹ̀tàn|ʃɛ̀tàn
ṣẹ̀ṣẹ|ʃɛ̀ʃɛ
ṣẹ̀ṣẹ̀|ʃɛ̀ʃɛ̀
ṣẹ̀’ka|ʃɛ̀’ka
ṣẹ́|ʃɛ́
ṣẹ́gun|ʃɛ́ɡũ
ṣẹ́jú|ʃɛ́d͡ʒú
ṣẹ́kù|ʃɛ́kù
ṣẹ́kẹ́ṣẹkẹ̀|ʃɛ́kɛ́ʃɛkɛ̀
ṣẹ́yún|ʃɛ́jún
ṣẹ’|ʃɛ’
ṣọ|ʃɔ
ṣọkọ|ʃɔkɔ
ṣọlá|ʃɔlá
ṣọlẹ̀|ʃɔlɛ̀
ṣọpẹ́|ʃɔk͡pɛ́
ṣọwọ́|ʃɔwɔ́
ṣọ̀|ʃɔ̀
ṣọ̀fọ̀|ʃɔ̀fɔ̀
ṣọ̀kan|ʃɔ̀kan
ṣọ̀pọ̀ná|ʃɔ̀k͡pɔ̀ná
ṣọ̀tẹ̀|ʃɔ̀tɛ̀
ṣọ̀wọ́n|ʃɔ̀wɔ́n
ṣọ́|ʃɔ́
ṣọ́nà|ʃɔ́nà
ṣọ́ra|ʃɔ́ra
ṣọ́wọ́|ʃɔ́wɔ́
ṣọ́ọ̀ṣì|ʃɔ́ɔ̀ʃì
ṣọ́’ra|ʃɔ́’ra
ṣ’aláì|ʃ’aláì
ṣ’ara|ʃ’ara
ṣ’eré|ʃ’eré
ṣ’oríire|ʃ’oríire
ṣ’àkàlàmàgò|ʃ’àkàlàmàɡò
ṣ’ọmọ|ʃ’ɔmɔ
ṣ’ọ̀lẹ|ʃ’ɔ̀lɛ
ạ̀|ạ̀
ẹbí|ɛbí
ẹbọ|ɛbɔ
ẹbọ’|ɛbɔ’
ẹfẹ̀|ɛfɛ̀
ẹfọ̀n|ɛfɔ̀n
ẹgbàajì|ɛɡ͡bàad͡ʒì
ẹgbàá|ɛɡ͡bàá
ẹgbàáfà|ɛɡ͡bàáfà
ẹgbàárùn|ɛɡ͡bàárùn
ẹgbẹgbẹ́|ɛɡ͡bɛɡ͡bɛ́
ẹgbẹ̀|ɛɡ͡bɛ̀
ẹgbẹ̀fà|ɛɡ͡bɛ̀fà
ẹgbẹ̀jọ|ɛɡ͡bɛ̀d͡ʒɔ
ẹgbẹ̀rin|ɛɡ͡bɛ̀rĩ
ẹgbẹ̀rin’|ɛɡ͡bɛ̀rĩ’
ẹgbẹ̀rún|ɛɡ͡bɛ̀rún
ẹgbẹ́|ɛɡ͡bɛ́
ẹgbẹ́ẹdógún|ɛɡ͡bɛ́ɛdóɡún
ẹgbẹ́ẹdọ́gbọ̀n|ɛɡ͡bɛ́ɛdɔ́ɡ͡bɔ̀n
ẹgbẹẹgbẹ̀rún|ɛɡ͡bɛɛɡ͡bɛ̀rún
ẹgbẹẹgbẹ́|ɛɡ͡bɛɛɡ͡bɛ́
ẹgbẹẹ̀rún|ɛɡ͡bɛɛ̀rún
ẹgbọrọ|ɛɡ͡bɔrɔ
ẹgbọ́n|ɛɡ͡bɔ́n
ẹhànnà|ɛhànnà
ẹjọ́|ɛd͡ʒɔ́
ẹkùn|ɛkùn
ẹkún|ɛkún
ẹlérin|ɛlérĩ
ẹlérìn|ɛlérìn
ẹlòmíràn|ɛlòmíràn
ẹlòmíràn’|ɛlòmíràn’
ẹlòmíì|ɛlòmíì
ẹlẹgbẹ́|ɛlɛɡ͡bɛ́
ẹlẹgẹ́|ɛlɛɡɛ́
ẹlẹ́bi|ɛlɛ́bi
ẹlẹ́dàá|ɛlɛ́dàá
ẹlẹ́dẹ̀|ɛlɛ́dɛ̀
ẹlẹ́gbin|ɛlɛ́ɡ͡bĩ
ẹlẹ́gbà|ɛlɛ́ɡ͡bà
ẹlẹ́gàn|ɛlɛ́ɡàn
ẹlẹ́hàá|ɛlɛ́hàá
ẹlẹ́kọ̀ọ́|ɛlɛ́kɔ̀ɔ́
ẹlẹ́mìí|ɛlɛ́mìí
ẹlẹ́ni|ɛlɛ́ni
ẹlẹ́nu|ɛlɛ́nu
ẹlẹ́pa|ɛlɛ́k͡pa
ẹlẹ́pà|ɛlɛ́k͡pà
ẹlẹ́ran|ɛlɛ́ran
ẹlẹ́rìí|ɛlɛ́rìí
ẹlẹ́shin|ɛlɛ́shĩ
ẹlẹ́sìn|ɛlɛ́sìn
ẹlẹ́sẹ̀|ɛlɛ́sɛ̀
ẹlẹ́ta|ɛlɛ́ta
ẹlẹ́tanu|ɛlɛ́tanu
ẹlẹ́tàn|ɛlɛ́tàn
ẹlẹ́wà|ɛlɛ́wà
ẹlẹ́wàa|ɛlɛ́wàa
ẹlẹ́wọ̀n|ɛlɛ́wɔ̀n
ẹlẹ́yà|ɛlɛ́jà
ẹlẹ́ǹgà|ɛlɛ́ǹɡà
ẹlẹ́ṣin|ɛlɛ́ʃĩ
ẹlẹ́ṣẹ̀|ɛlɛ́ʃɛ̀
ẹlẹ́ṣẹ̀’|ɛlɛ́ʃɛ̀’
ẹlẹ́ẹ̀karùnún|ɛlɛ́ɛ̀karùnún
ẹlẹ́ẹ̀kejì|ɛlɛ́ɛ̀ked͡ʒì
ẹlẹ́ẹ̀kẹrin|ɛlɛ́ɛ̀kɛrĩ
ẹlẹ́ẹ̀kẹta|ɛlɛ́ɛ̀kɛta
ẹni|ɛ̃i
ẹniafẹ́|ɛ̃iafɛ́
ẹnikan|ɛ̃ikan
ẹnikéni|ɛ̃ikéni
ẹnikẹ́|ɛ̃ikɛ́
ẹnikẹ́ni|ɛ̃ikɛ́ni
ẹniyàn|ɛ̃ijàn
ẹniọlá|ɛ̃iɔlá
ẹnu|ɛ̃u
ẹnìkan|ɛ̃ìkan
ẹnìkankan|ɛ̃ìkankan
ẹnìkejì|ɛ̃ìked͡ʒì
ẹnìkéjì|ɛ̃ìkéd͡ʒì
ẹnìkínní|ɛ̃ìkínní
ẹnìkọ̀ọ̀|ɛ̃ìkɔ̀ɔ̀
ẹnìkọ̀ọ̀kan|ɛ̃ìkɔ̀ɔ̀kan
ẹní|ɛ̃í
ẹnú|ɛ̃ú
ẹpọ̀n|ɛk͡pɔ̀n
ẹran|ɛran
ẹranko|ɛranko
ẹrankẹ́ran|ɛrankɛ́ran
ẹrankọ|ɛrankɔ
ẹrán|ɛrán
ẹrù|ɛrù
ẹrú|ɛrú
ẹrúbìnrin|ɛrúbìnrĩ
ẹrúkùnrin|ɛrúkùnrĩ
ẹrẹ̀|ɛrɛ̀
ẹrọ̀fọ̀|ɛrɔ̀fɔ̀
ẹsítétì|ɛsítétì
ẹsítẹ́tì|ɛsítɛ́tì
ẹsẹ̀|ɛsɛ̀
ẹsẹ̀’|ɛsɛ̀’
ẹsẹẹsẹ|ɛsɛɛsɛ
ẹwà|ɛwà
ẹwẹ̀|ɛwɛ̀
ẹwọ̀n|ɛwɔ̀n
ẹyìn|ɛjìn
ẹyín|ɛjín
ẹyíòwùnmí|ɛjíòwùnmí
ẹyẹlé|ɛjɛlé
ẹyẹ́|ɛjɛ́
ẹyọ|ɛjɔ
ẹ̀|ɛ̀
ẹ̀bi|ɛ̀bi
ẹ̀bun|ɛ̀bũ
ẹ̀bá|ɛ̀bá
ẹ̀bùn|ɛ̀bùn
ẹ̀bún|ɛ̀bún
ẹ̀bẹ̀|ɛ̀bɛ̀
ẹ̀dá|ɛ̀dá
ẹ̀dùn|ɛ̀dùn
ẹ̀dọ̀|ɛ̀dɔ̀
ẹ̀fúùfù|ɛ̀fúùfù
ẹ̀fẹ̀|ɛ̀fɛ̀
ẹ̀fọn|ɛ̀fɔ̃
ẹ̀fọ́|ɛ̀fɔ́
ẹ̀fọ́rí|ɛ̀fɔ́rí
ẹ̀fọ̣n|ɛ̀fɔ̣n
ẹ̀gbin|ɛ̀ɡ͡bĩ
ẹ̀gbà|ɛ̀ɡ͡bà
ẹ̀gbín|ɛ̀ɡ͡bín
ẹ̀gbẹjọ̀|ɛ̀ɡ͡bɛd͡ʒɔ̀
ẹ̀gbẹ̀gbẹ́|ɛ̀ɡ͡bɛ̀ɡ͡bɛ́
ẹ̀gbẹ̀ẹ̀gbẹ́|ɛ̀ɡ͡bɛ̀ɛ̀ɡ͡bɛ́
ẹ̀gbẹ́|ɛ̀ɡ͡bɛ́
ẹ̀gbọ̀n|ɛ̀ɡ͡bɔ̀n
ẹ̀gbọ́n|ɛ̀ɡ͡bɔ́n
ẹ̀gàn|ɛ̀ɡàn
ẹ̀gún|ɛ̀ɡún
ẹ̀gún’|ɛ̀ɡún’
ẹ̀gẹ́|ɛ̀ɡɛ́
ẹ̀jẹ̀|ɛ̀d͡ʒɛ̀
ẹ̀jẹ́|ɛ̀d͡ʒɛ́
ẹ̀ka|ɛ̀ka
ẹ̀karùnún|ɛ̀karùnún
ẹ̀kún|ɛ̀kún
ẹ̀kúnrẹ́rẹ́|ɛ̀kúnrɛ́rɛ́
ẹ̀kúnwọ́|ɛ̀kúnwɔ́
ẹ̀kẹfà|ɛ̀kɛfà
ẹ̀kẹjọ|ɛ̀kɛd͡ʒɔ
ẹ̀kẹrin|ɛ̀kɛrĩ
ẹ̀kẹta|ɛ̀kɛta
ẹ̀kọ̀|ɛ̀kɔ̀
ẹ̀kọ́|ɛ̀kɔ́
ẹ̀là|ɛ̀là
ẹ̀mí|ɛ̀mí
ẹ̀pà|ɛ̀k͡pà
ẹ̀rí|ɛ̀rí
ẹ̀rín|ɛ̀rín
ẹ̀rù|ɛ̀rù
ẹ̀rún|ɛ̀rún
ẹ̀rẹ̀kẹ́|ɛ̀rɛ̀kɛ́
ẹ̀rọ|ɛ̀rɔ
ẹ̀rọ̀|ɛ̀rɔ̀
ẹ̀san|ɛ̀san
ẹ̀sin|ɛ̀sĩ
ẹ̀sìn|ɛ̀sìn
ẹ̀sín|ɛ̀sín
ẹ̀sítérì|ɛ̀sítérì
ẹ̀sùn|ɛ̀sùn
ẹ̀sẹ̀|ɛ̀sɛ̀
ẹ̀sọ̀|ɛ̀sɔ̀
ẹ̀sọ́|ɛ̀sɔ́
ẹ̀tàn|ɛ̀tàn
ẹ̀tù|ɛ̀tù
ẹ̀tẹ̀|ɛ̀tɛ̀
ẹ̀tẹ́|ɛ̀tɛ́
ẹ̀tọ́|ɛ̀tɔ́
ẹ̀wà|ɛ̀wà
ẹ̀wù|ɛ̀wù
ẹ̀wẹ̀|ɛ̀wɛ̀
ẹ̀wọ̀n|ɛ̀wɔ̀n
ẹ̀ya|ɛ̀ja
ẹ̀yin|ɛ̀jĩ
ẹ̀yà|ɛ̀jà
ẹ̀yìn|ɛ̀jìn
ẹ̀yìnkùlé|ɛ̀jìnkùlé
ẹ̀yín|ɛ̀jín
ẹ̀yíòwùnmí|ɛ̀jíòwùnmí
ẹ̀yẹ|ɛ̀jɛ
ẹ̀yọ̀|ɛ̀jɔ̀
ẹ̀ṣẹ̀|ɛ̀ʃɛ̀
ẹ̀ṣẹ̀kẹ́ṣẹ̀|ɛ̀ʃɛ̀kɛ́ʃɛ̀
ẹ̀ṣọ́|ɛ̀ʃɔ́
ẹ̀ẹ̀|ɛ̀ɛ̀
ẹ̀ẹ̀kan|ɛ̀ɛ̀kan
ẹ̀ẹ̀kejì|ɛ̀ɛ̀ked͡ʒì
ẹ̀ẹ̀kẹrin|ɛ̀ɛ̀kɛrĩ
ẹ̀ẹ̀kẹ́ta|ɛ̀ɛ̀kɛ́ta
ẹ̀ẹ̀mejì|ɛ̀ɛ̀med͡ʒì
ẹ̀ẹ̀méje|ɛ̀ɛ̀méd͡ʒe
ẹ̀ẹ̀mẹta|ɛ̀ɛ̀mɛta
ẹ̀ẹ̀mẹ́ta|ɛ̀ɛ̀mɛ́ta
ẹ̀ẹ̀rùn|ɛ̀ɛ̀rùn
ẹ̀ẹ́dẹ́gbàárin|ɛ̀ɛ́dɛ́ɡ͡bàárĩ
ẹ̀ẹ́dẹ́gbàéjìlá|ɛ̀ɛ́dɛ́ɡ͡bàéd͡ʒìlá
ẹ̀ẹ́dẹ́gbẹ̀ta|ɛ̀ɛ́dɛ́ɡ͡bɛ̀ta
ẹ̀ẹ́dẹ́gbẹ́je|ɛ̀ɛ́dɛ́ɡ͡bɛ́d͡ʒe
ẹ̀ẹ́dẹ́ɡbarin|ɛ̀ɛ́dɛ́ɡbarĩ
ẹ́|ɛ́
ẹ́nikẹ́ni|ɛ́nikɛ́ni
ẹ́sítérì|ɛ́sítérì
ẹ́yin|ɛ́jĩ
ẹṣin|ɛʃĩ
ẹṣẹ|ɛʃɛ
ẹṣẹ̀|ɛʃɛ̀
ẹẹ́|ɛɛ́
ọ|ɔ
ọba|ɔba
ọbabìnrin|ɔbabìnrĩ
ọbabìrin|ɔbabìrĩ
ọbaléndé|ɔbaléndé
ọbalùfọ̀n|ɔbalùfɔ̀n
ọbàkan|ɔbàkan
ọbá|ɔbá
ọbásanjọ́|ɔbásand͡ʒɔ́
ọbẹdo|ɔbɛdo
ọbẹ̀|ɔbɛ̀
ọbọ̀kún|ɔbɔ̀kún
ọde|ɔde
ọdán|ɔdán
ọdùn|ɔdùn
ọdún|ɔdún
ọdúnm̀bákú|ɔdúnm̀bákú
ọdẹ́|ɔdɛ́
ọdẹ́kù|ɔdɛ́kù
ọdọọdún|ɔdɔɔdún
ọfà|ɔfà
ọgbà|ɔɡ͡bà
ọgbẹ́|ɔɡ͡bɛ́
ọgbọ̀n|ɔɡ͡bɔ̀n
ọgbọ̀nlénírinwó|ɔɡ͡bɔ̀nlénírĩwó
ọgbọ́|ɔɡ͡bɔ́
ọgbọ́n|ɔɡ͡bɔ́n
ọgbọ́nkọ́gbọ́n|ɔɡ͡bɔ́nkɔ́ɡ͡bɔ́n
ọgbọọgbọ̀n|ɔɡ͡bɔɔɡ͡bɔ̀n
ọgọ́|ɔɡɔ́
ọgọ́fà|ɔɡɔ́fà
ọgọ́rin|ɔɡɔ́rĩ
ọgọ́rùn|ɔɡɔ́rùn
ọgọ́sàn|ɔɡɔ́sàn
ọgọ́ta|ɔɡɔ́ta
ọgọ́tọ̀ọ̀ta|ɔɡɔ́tɔ̀ɔ̀ta
ọgọọgọ́rùn|ɔɡɔɔɡɔ́rùn
ọgọọgọ́ta|ɔɡɔɔɡɔ́ta
ọjà|ɔd͡ʒà
ọjọ́|ɔd͡ʒɔ́
ọjọ́’|ɔd͡ʒɔ́’
ọjọọjọ́|ɔd͡ʒɔɔd͡ʒɔ́
ọko|ɔko
ọkunrin|ɔkũrĩ
ọkà|ɔkà
ọkàn|ɔkàn
ọkùnrin|ɔkùnrĩ
ọkùrin|ɔkùrĩ
ọkọnítorí|ɔkɔ̃ítorí
ọkọ̀|ɔkɔ̀
ọkọ́|ɔkɔ́
ọkọọ̀|ɔkɔɔ̀
ọlá|ɔlá
ọlábìntán|ɔlábìntán
ọlábíntán|ɔlábíntán
ọládiípọ̀|ɔládiík͡pɔ̀
ọládèjì|ɔládèd͡ʒì
ọládèjọ|ɔládèd͡ʒɔ
ọládìjì|ɔládìd͡ʒì
ọládìípò|ɔládìík͡pò
ọládíji|ɔládíd͡ʒi
ọládùnúní|ɔládùnúní
ọláfibọ̀|ɔláfibɔ̀
ọlájídé|ɔlád͡ʒídé
ọlájùwọ́n|ɔlád͡ʒùwɔ́n
ọlákúnlé|ɔlákúnlé
ọlámide|ɔlámide
ọlámilékan|ɔlámilékan
ọlánipẹ̀kún|ɔlánik͡pɛ̀kún
ọlárótìmí|ɔlárótìmí
ọlárótìwọ́n|ɔlárótìwɔ́n
ọláwùnmí|ɔláwùnmí
ọláànipẹ̀kún|ɔláànik͡pɛ̀kún
ọláńlá|ɔláńlá
ọláṣayọ̀|ɔláʃajɔ̀
ọlórun|ɔlórũ
ọlóṛun|ɔlóṛũ
ọlẹ̀|ɔlɛ̀
ọlọkùnrùn|ɔlɔkùnrùn
ọlọ̀run|ɔlɔ̀rũ
ọlọ̀tẹ̀|ɔlɔ̀tɛ̀
ọlọ́bùn|ɔlɔ́bùn
ọlọ́dún|ɔlɔ́dún
ọlọ́dọọdún|ɔlɔ́dɔɔdún
ọlọ́fin|ɔlɔ́fĩ
ọlọ́gbọ́n|ɔlɔ́ɡ͡bɔ́n
ọlọ́jà|ɔlɔ́d͡ʒà
ọlọ́jọ́|ɔlɔ́d͡ʒɔ́
ọlọ́kadà|ɔlɔ́kadà
ọlọ́kàn|ɔlɔ́kàn
ọlọ́kọ̀|ɔlɔ́kɔ̀
ọlọ́kọ́|ɔlɔ́kɔ́
ọlọ́lá|ɔlɔ́lá
ọlọ́mọ|ɔlɔ́mɔ
ọlọ́nà|ɔlɔ́nà
ọlọ́pàá|ɔlɔ́k͡pàá
ọlọ́pẹ|ɔlɔ́k͡pɛ
ọlọ́pọ́n|ɔlɔ́k͡pɔ́n
ọlọ́run|ɔlɔ́rũ
ọlọ́runtí|ɔlɔ́rũtí
ọlọ́runyọmí|ɔlɔ́rũjɔmí
ọlọ́run’|ɔlɔ́rũ’
ọlọ́ràá|ɔlɔ́ràá
ọlọ́rùn|ɔlɔ́rùn
ọlọ́rẹ|ɔlɔ́rɛ
ọlọ́rọ̀|ɔlɔ́rɔ̀
ọlọ́ṣà|ɔlɔ́ʃà
ọlọ́ṣọ̀ọ́|ɔlɔ́ʃɔ̀ɔ́
ọmi|ɔmi
ọmo|ɔmo
ọmú|ɔmú
ọmọ|ɔmɔ
ọmọ'bìrin|ɔmɔ'bìrĩ
ọmọbìnrin|ɔmɔbìnrĩ
ọmọbìrin|ɔmɔbìrĩ
ọmọdé|ɔmɔdé
ọmọdébìnrin|ɔmɔdébìnrĩ
ọmọdékùnrin|ɔmɔdékùnrĩ
ọmọkùnrin|ɔmɔkùnrĩ
ọmọkọ́mọ|ɔmɔkɔ́mɔ
ọmọlóòkú|ɔmɔlóòkú
ọmọnìkejì|ɔmɔ̃ìked͡ʒì
ọmọ̀wé|ɔmɔ̀wé
ọmọ́|ɔmɔ́
ọmọ́yẹlẹ́|ɔmɔ́jɛlɛ́
ọmọṣẹwà|ɔmɔʃɛwà
ọn|ɔ̃
ọnà|ɔ̃à
ọpẹ́|ɔk͡pɛ́
ọpẹ́lọpẹ́|ɔk͡pɛ́lɔk͡pɛ́
ọpọ́n|ɔk͡pɔ́n
ọrùn|ɔrùn
ọrún|ɔrún
ọrẹ|ɔrɛ
ọrẹolúwa|ɔrɛolúwa
ọrẹ́|ɔrɛ́
ọrọ̀|ɔrɔ̀
ọrọọrún|ɔrɔɔrún
ọsàn|ɔsàn
ọtí|ɔtí
ọwá|ɔwá
ọwọ́|ɔwɔ́
ọyàn|ɔjàn
ọyún|ɔjún
ọyẹ́|ɔjɛ́
ọìtumọ̀|ɔìtumɔ̀
ọ̀|ɔ̀
ọ̀bùn|ɔ̀bùn
ọ̀bẹ|ɔ̀bɛ
ọ̀bọ|ɔ̀bɔ
ọ̀bọ̀kún|ɔ̀bɔ̀kún
ọ̀bọ́|ɔ̀bɔ́
ọ̀daràn|ɔ̀daràn
ọ̀dà|ɔ̀dà
ọ̀dàlẹ̀|ɔ̀dàlɛ̀
ọ̀dá|ɔ̀dá
ọ̀dájú|ɔ̀dád͡ʒú
ọ̀dán|ɔ̀dán
ọ̀dẹ̀|ɔ̀dɛ̀
ọ̀dẹ̀dẹ̀|ɔ̀dɛ̀dɛ̀
ọ̀dọ̀|ɔ̀dɔ̀
ọ̀dọ̀dọ̀|ɔ̀dɔ̀dɔ̀
ọ̀dọ́|ɔ̀dɔ́
ọ̀dọ́bìnrin|ɔ̀dɔ́bìnrĩ
ọ̀dọ́mọbìnrin|ɔ̀dɔ́mɔbìnrĩ
ọ̀dọ́mọdé|ɔ̀dɔ́mɔdé
ọ̀dọ́mọge|ɔ̀dɔ́mɔɡe
ọ̀dọ́mọgé|ɔ̀dɔ́mɔɡé
ọ̀dọ́mọkùnrin|ɔ̀dɔ́mɔkùnrĩ
ọ̀fun|ɔ̀fũ
ọ̀fà|ɔ̀fà
ọ̀fìn|ɔ̀fìn
ọ̀fẹ́|ɔ̀fɛ́
ọ̀fọ̀|ɔ̀fɔ̀
ọ̀gangan|ɔ̀ɡanɡan
ọ̀gbun|ɔ̀ɡ͡bũ
ọ̀gbun’|ɔ̀ɡ͡bũ’
ọ̀gbìn|ɔ̀ɡ͡bìn
ọ̀gbẹlẹ̀|ɔ̀ɡ͡bɛlɛ̀
ọ̀gbẹ́|ɔ̀ɡ͡bɛ́
ọ̀gbẹ́ni|ɔ̀ɡ͡bɛ́ni
ọ̀gbọ̀|ɔ̀ɡ͡bɔ̀
ọ̀gàn|ɔ̀ɡàn
ọ̀gànjọ́|ɔ̀ɡànd͡ʒɔ́
ọ̀gá|ɔ̀ɡá
ọ̀gágun|ɔ̀ɡáɡũ
ọ̀gẹ̀dẹ̀|ɔ̀ɡɛ̀dɛ̀
ọ̀gọ̀|ɔ̀ɡɔ̀
ọ̀gọ̀dẹ̀|ɔ̀ɡɔ̀dɛ̀
ọ̀gọ̀njọ́|ɔ̀ɡɔ̀nd͡ʒɔ́
ọ̀gọ̀ọ̀rọ̀|ɔ̀ɡɔ̀ɔ̀rɔ̀
ọ̀hún|ɔ̀hún
ọ̀já|ɔ̀d͡ʒá
ọ̀jábó|ɔ̀d͡ʒábó
ọ̀jògbón|ɔ̀d͡ʒòɡ͡bón
ọ̀jẹun|ɔ̀d͡ʒɛũ
ọ̀jọ̀gbọ́n|ɔ̀d͡ʒɔ̀ɡ͡bɔ́n
ọ̀kan|ɔ̀kan
ọ̀kankan|ɔ̀kankan
ọ̀kànlélógójì|ɔ̀kànlélóɡód͡ʒì
ọ̀kánkán|ɔ̀kánkán
ọ̀kẹ|ɔ̀kɛ
ọ̀kẹ́|ɔ̀kɛ́
ọ̀kẹ́rẹ́|ɔ̀kɛ́rɛ́
ọ̀kọ̀|ɔ̀kɔ̀
ọ̀kọ̀ọ̀|ɔ̀kɔ̀ɔ̀
ọ̀kọ̀ọ̀kan|ɔ̀kɔ̀ɔ̀kan
ọ̀l|ɔ̀l
ọ̀la|ɔ̀la
ọ̀làjú|ɔ̀làd͡ʒú
ọ̀lá|ɔ̀lá
ọ̀lẹ|ɔ̀lɛ
ọ̀mùnú|ɔ̀mùnú
ọ̀mùtí|ɔ̀mùtí
ọ̀mùtípara|ɔ̀mùtík͡para
ọ̀mọ̀lé|ɔ̀mɔ̀lé
ọ̀mọ̀ran|ɔ̀mɔ̀ran
ọ̀mọ̀wé|ɔ̀mɔ̀wé
ọ̀na|ɔ̀na
ọ̀nà|ɔ̀nà
ọ̀nàkọnà|ɔ̀nàkɔ̃à
ọ̀pá|ɔ̀k͡pá
ọ̀págun|ɔ̀k͡páɡũ
ọ̀pẹ|ɔ̀k͡pɛ
ọ̀pẹ̀bí|ɔ̀k͡pɛ̀bí
ọ̀pẹ́ẹ̀rẹ́|ɔ̀k͡pɛ́ɛ̀rɛ́
ọ̀pọ̀|ɔ̀k͡pɔ̀
ọ̀pọ̀lọpọ̀|ɔ̀k͡pɔ̀lɔk͡pɔ̀
ọ̀pọ̀lọ́|ɔ̀k͡pɔ̀lɔ́
ọ̀pọ̀tọ́|ɔ̀k͡pɔ̀tɔ́
ọ̀run|ɔ̀rũ
ọ̀run’|ɔ̀rũ’
ọ̀ràn|ɔ̀ràn
ọ̀rá|ɔ̀rá
ọ̀rìn|ɔ̀rìn
ọ̀rò|ɔ̀rò
ọ̀rún|ɔ̀rún
ọ̀rúnmìlà|ɔ̀rúnmìlà
ọ̀rẹ̀|ɔ̀rɛ̀
ọ̀rẹ́|ɔ̀rɛ́
ọ̀rẹ́bìrin|ɔ̀rɛ́bìrĩ
ọ̀rẹ́kùnrin|ɔ̀rɛ́kùnrĩ
ọ̀rọ̀|ɔ̀rɔ̀
ọ̀rọ̀ọ̀rún|ɔ̀rɔ̀ɔ̀rún
ọ̀sun|ɔ̀sũ
ọ̀sà|ɔ̀sà
ọ̀sán|ɔ̀sán
ọ̀sìn|ɔ̀sìn
ọ̀sún|ɔ̀sún
ọ̀sẹ̀|ɔ̀sɛ̀
ọ̀ta|ɔ̀ta
ọ̀tun|ɔ̀tũ
ọ̀tà|ɔ̀tà
ọ̀tá|ɔ̀tá
ọ̀tún|ɔ̀tún
ọ̀túnba|ɔ̀túnba
ọ̀túnla|ɔ̀túnla
ọ̀tútù|ɔ̀tútù
ọ̀tẹ̀|ɔ̀tɛ̀
ọ̀tọ̀|ɔ̀tɔ̀
ọ̀tọ̀ọ̀tọ̀|ɔ̀tɔ̀ɔ̀tɔ̀
ọ̀wààrà|ɔ̀wààrà
ọ̀wá|ɔ̀wá
ọ̀wọn|ɔ̀wɔ̃
ọ̀wọ̀|ɔ̀wɔ̀
ọ̀wọ̀n|ɔ̀wɔ̀n
ọ̀wọ̀ọ̀wọ́|ɔ̀wɔ̀ɔ̀wɔ́
ọ̀wọ́|ɔ̀wɔ́
ọ̀wọ́n|ɔ̀wɔ́n
ọ̀yà|ɔ̀jà
ọ̀yọ́|ɔ̀jɔ́
ọ̀ṣun|ɔ̀ʃũ
ọ̀ṣínbájò|ɔ̀ʃínbád͡ʒò
ọ̀ṣọ́|ɔ̀ʃɔ́
ọ̀ọ̀dẹ̀|ɔ̀ɔ̀dɛ̀
ọ̀ọ̀nì|ɔ̀ɔ̀nì
ọ̀ọ́dúnrún|ɔ̀ɔ́dúnrún
ọ̀ọ́dẹ́gbẹ̀ta|ɔ̀ɔ́dɛ́ɡ͡bɛ̀ta
ọ̀ọ́kán|ɔ̀ɔ́kán
ọ́|ɔ́
ọ́dọ̀|ɔ́dɔ̀
ọ́fìsì|ɔ́fìsì
ọ́kọ̀|ɔ́kɔ̀
ọ́mọ|ɔ́mɔ
ọ́n|ɔ́n
ọ́nà|ɔ́nà
ọ́rẹ́|ɔ́rɛ́
ọ́’|ɔ́’
ọḷ́opàá|ɔḷ́ok͡pàá
ọṣán|ɔʃán
ọṣẹ|ɔʃɛ
ọọ̀|ɔɔ̀
ọ’|ɔ’
ọ”|ɔ”
‘|‘
‘a|‘a
‘ará|‘ará
‘arábìnrin|‘arábìnrĩ
‘arákùnrin|‘arákùnrĩ
‘aya|‘aja
‘baba|‘baba
‘bi|‘bi
‘bákan|‘bákan
‘báwo|‘báwo
‘báyìí|‘bájìí
‘bí|‘bí
‘bẹ́ẹ̀|‘bɛ́ɛ̀
‘bọ́|‘bɔ́
‘darí|‘darí
‘dá|‘dá
‘dájúdájú|‘dád͡ʒúdád͡ʒú
‘dìde|‘dìde
‘dọ̀bálẹ̀|‘dɔ̀bálɛ̀
‘e|‘e
‘fi|‘fi
‘fún|‘fún
‘fẹ́|‘fɛ́
‘fẹ́ràn|‘fɛ́ràn
‘gbogbo|‘ɡ͡boɡ͡bo
‘gbé|‘ɡ͡bé
‘gbọ́|‘ɡ͡bɔ́
‘gé|‘ɡé
‘gẹ́gẹ́|‘ɡɛ́ɡɛ́
‘ibi|‘ibi
‘igúnnugún|‘iɡúnnuɡún
‘ilé|‘ilé
‘ilẹ̀|‘ilɛ̀
‘ipò|‘ik͡pò
‘irú|‘irú
‘jakọbu|‘d͡ʒakɔbu
‘jáde|‘d͡ʒáde
‘jẹ́|‘d͡ʒɛ́
‘jọ̀wọ́|‘d͡ʒɔ̀wɔ́
‘jọ́|‘d͡ʒɔ́
‘korneliu|‘korneliu
‘kì|‘kì
‘kí|‘kí
‘kín|‘kín
‘kíá|‘kíá
‘kò|‘kò
‘kòkòrò|‘kòkòrò
‘lebanoni|‘lebanoni
‘láti|‘láti
‘láàrín|‘láàrín
‘láìpẹ́|‘láìk͡pɛ́
‘lé|‘lé
‘lóòótọ́|‘lóòótɔ́
‘lẹ̀|‘lɛ̀
‘lẹ́yìn|‘lɛ́jìn
‘lọ|‘lɔ
‘mo|‘mo
‘má|‘má
‘mélòó|‘mélòó
‘múra|‘múra
‘ní|‘ní
‘níbi|‘níbi
‘níbo|‘níbo
‘níbẹ̀|‘níbɛ̀
‘nígbà|‘níɡ͡bà
‘nínú|‘nínú
‘nísinsin|‘nísĩsĩ
‘nítorí|‘nítorí
‘níwọ́n|‘níwɔ́n
‘ohun|‘ohũ
‘olùbùkún|‘olùbùkún
‘olùkọ́’|‘olùkɔ́’
‘olùṣọ́|‘olùʃɔ́
‘olúwa|‘olúwa
‘pa|‘k͡pa
‘pe|‘k͡pe
‘pèsè|‘k͡pèsè
‘pẹ̀lú|‘k͡pɛ̀lú
‘ra|‘ra
‘rin|‘rĩ
‘rárá|‘rárá
‘ráákà|‘ráákà
‘san|‘san
‘saulu|‘saulu
‘síbẹ̀|‘síbɛ̀
‘sípò|‘sík͡pò
‘ta|‘ta
‘torí|‘torí
‘tàbí|‘tàbí
‘tábìlì|‘tábìlì
‘tí|‘tí
‘tẹ́tí|‘tɛ́tí
‘wo|‘wo
‘wò|‘wò
‘wúńdíá|‘wúńdíá
‘wọn|‘wɔ̃
‘wọ́n|‘wɔ́n
‘yóò|‘jóò
‘à|‘à
‘àlùfáà|‘àlùfáà
‘àpótí|‘àk͡pótí
‘àti|‘àti
‘àwa|‘àwa
‘àwọn|‘àwɔ̃
‘àyànfẹ́|‘àjànfɛ́
‘àánú|‘àánú
‘ègbé|‘èɡ͡bé
‘èkínní|‘èkínní
‘èló|‘èló
‘èmi|‘èmi
‘ènìyàn|‘ènìjàn
‘èrè|‘èrè
‘èwo|‘èwo
‘èyí|‘èjí
‘èéha|‘èéha
‘èéṣe|‘èéʃe
‘ìbùkún|‘ìbùkún
‘ìjìnlẹ̀|‘ìd͡ʒìnlɛ̀
‘ìjọba|‘ìd͡ʒɔba
‘ìkòkò|‘ìkòkò
‘ìlú|‘ìlú
‘ìwà|‘ìwà
‘ìwọ|‘ìwɔ
‘ìwọ̀nyí|‘ìwɔ̀njí
‘ìyàwó|‘ìjàwó
‘ìyá|‘ìjá
‘òfin|‘òfĩ
‘ògo|‘òɡo
‘òkú|‘òkú
‘òkúta|‘òkúta
‘òun|‘òũ
‘ó|‘ó
‘ǹjẹ́|‘ǹd͡ʒɛ́
‘ṣe|‘ʃe
‘ṣé|‘ʃé
‘ṣùgbọ́n|‘ʃùɡ͡bɔ́n
‘ẹ|‘ɛ
‘ẹni|‘ɛ̃i
‘ẹnikẹ́ni|‘ɛ̃ikɛ́ni
‘ẹnìkan|‘ɛ̃ìkan
‘ẹranko|‘ɛranko
‘ẹ̀rù|‘ɛ̀rù
‘ẹ̀yin|‘ɛ̀jĩ
‘ọkùnrin|‘ɔkùnrĩ
‘ọkọ|‘ɔkɔ
‘ọlọ́run|‘ɔlɔ́rũ
‘ọmọ|‘ɔmɔ
‘ọ̀nà|‘ɔ̀nà
‘ọ̀rẹ́|‘ɔ̀rɛ́
‘ọ̀rọ̀|‘ɔ̀rɔ̀
‘ọ̀wààrà|‘ɔ̀wààrà
’|’
’gbọ̀nsẹ̀|’ɡ͡bɔ̀nsɛ̀
’lé|’lé
’àti|’àti
“|“
“a|“a
“aaroni|“aaroni
“abrahamu|“abrahamu
“adamu|“adamu
“afọ́jú|“afɔ́d͡ʒú
“agara|“aɡara
“agbára|“aɡ͡bára
“ago|“aɡo
“agrippa|“aɡrik͡pk͡pa
“akẹ́kọ̀ọ́|“akɛ́kɔ̀ɔ́
“alàgbà|“alàɡ͡bà
“alábojútó|“alábod͡ʒútó
“alábùkún|“alábùkún
“alátakò|“alátakò
“amaleki|“amaleki
“amariah|“amariah
“anania|“anania
“angẹli|“anɡɛli
“ara|“ara
“ará|“ará
“arábìnrin|“arábìnrĩ
“arákùnrin|“arákùnrĩ
“asiria|“asiria
“baba|“baba
“babeli|“babeli
“baraba|“baraba
“belṣassari|“belʃassari
“benjamini|“bend͡ʒamĩi
“biliha|“biliha
“bosra|“bosra
“bá|“bá
“báwo|“báwo
“báyìí|“bájìí
“béèrè|“béèrè
“bì|“bì
“bí|“bí
“bẹ́|“bɛ́
“bẹ́ẹ̀|“bɛ́ɛ̀
“dafidi|“dafidi
“daniẹli|“daniɛli
“darandaran|“darandaran
“dojúkọ|“dod͡ʒúkɔ
“dájúdájú|“dád͡ʒúdád͡ʒú
“dìde|“dìde
“dúró|“dúró
“e|“e
“ebi|“ebi
“edomu|“edomu
“el|“el
“elijah|“elid͡ʒah
“eléyìí|“eléjìí
“farao|“farao
“fetísílẹ̀|“fetísílɛ̀
“fi|“fi
“finehasi|“fĩehasi
“fún|“fún
“fẹ́|“fɛ́
“gaali|“ɡaali
“gba|“ɡ͡ba
“gbogbo|“ɡ͡boɡ͡bo
“gbà|“ɡ͡bà
“gbé|“ɡ͡bé
“gbéra|“ɡ͡béra
“gbọ́|“ɡ͡bɔ́
“gòkè|“ɡòkè
“gẹ́gẹ́|“ɡɛ́ɡɛ́
“hagari|“haɡari
“hana|“hana
“háà|“háà
“hú|“hú
“ibo|“ibo
“ibùgbé|“ibùɡ͡bé
“idà|“idà
“igbe|“iɡ͡be
“igi|“iɡi
“ilẹ̀|“ilɛ̀
“irú|“irú
“israẹli|“israɛli
“iwin|“iwĩ
“iyọ̀|“ijɔ̀
“iṣmaeli|“iʃmaeli
“iṣẹ́|“iʃɛ́
“jehu|“d͡ʒehu
“jesu|“d͡ʒesu
“johanu|“d͡ʒohanu
“jáde|“d͡ʒáde
“jókòó|“d͡ʒókòó
“júù|“d͡ʒúù
“jẹ́|“d͡ʒɛ́
“jọba|“d͡ʒɔba
“jọ̀wọ́|“d͡ʒɔ̀wɔ́
“ka|“ka
“ki|“ki
“ko|“ko
“korneliu|“korneliu
“koríko|“koríko
“kristi|“kristi
“kristiani|“kristiani
“kàn|“kàn
“kábíyèsí|“kábíjèsí
“kì|“kì
“kí|“kí
“kígbe|“kíɡ͡be
“kíkú|“kíkú
“kín|“kín
“kíyèsi|“kíjèsi
“kíyèsára|“kíjèsára
“kíyèsí|“kíjèsí
“kíákíá|“kíákíá
“kò|“kò
“kó|“kó
“kódà|“kódà
“kúrò|“kúrò
“kọ|“kɔ
“kọlu|“kɔlu
“kọ̀wé|“kɔ̀wé
“kọ́kọ́|“kɔ́kɔ́
“lasaru|“lasaru
“lu|“lu
“lásán|“lásán
“láti|“láti
“láàrín|“láàrín
“láìpẹ́|“láìk͡pɛ́
“lé|“lé
“lílì|“lílì
“lòdì|“lòdì
“lójúkan|“lód͡ʒúkan
“lónìí|“lónìí
“lórí|“lórí
“lóòótọ́|“lóòótɔ́
“lẹ́yìn|“lɛ́jìn
“lẹ́ẹ̀kan|“lɛ́ɛ̀kan
“lọ|“lɔ
“lọ́dọ̀|“lɔ́dɔ̀
“lọ́pọ̀|“lɔ́k͡pɔ̀
“lọ́wọ́|“lɔ́wɔ́
“marta|“marta
“mene|“mene
“messia|“messia
“mikaiah|“mikaiah
“milka|“milka
“mo|“mo
“mose|“mose
“má|“má
“máa|“máa
“mú|“mú
“n|“n
“na|“na
“nebukadnessari|“nebukadnessari
“ní|“ní
“níbi|“níbi
“níbo|“níbo
“níbí|“níbí
“níbẹ̀|“níbɛ̀
“nígbà|“níɡ͡bà
“níkẹyìn|“níkɛjìn
“nínú|“nínú
“nípa|“ník͡pa
“nísinsin|“nísĩsĩ
“nítorí|“nítorí
“nítòótọ́|“nítòótɔ́
“níwọ́n|“níwɔ́n
“nǹkan|“nǹkan
“o|“o
“obìnrin|“obìnrĩ
“odi|“odi
“ohun|“ohũ
“ohunkóhun|“ohũkóhũ
“ohùn|“ohùn
“ojú|“od͡ʒú
“olódodo|“olódodo
“olóòtítọ́|“olóòtítɔ́
“olóòótọ́|“olóòótɔ́
“olùbùkún|“olùbùkún
“olùdáǹdè|“olùdáǹdè
“olùkọ́|“olùkɔ́
“olùkọ́ni|“olùkɔ́ni
“olúwa|“olúwa
“oore|“oore
“orí|“orí
“orílẹ̀|“orílɛ̀
“owó|“owó
“oúnjẹ|“oúnd͡ʒɛ
“oṣù|“oʃù
“padà|“k͡padà
“paulu|“k͡paulu
“pe|“k͡pe
“peresini|“k͡peresĩi
“pẹ̀lú|“k͡pɛ̀lú
“rabbi|“rabbi
“rara|“rara
“rere|“rere
“rán|“rán
“rántí|“rántí
“rárá|“rárá
“rékọjá|“rékɔd͡ʒá
“rí|“rí
“rírẹ́|“rírɛ́
“sakeu|“sakeu
“sebuluni|“sebulũi
“simoni|“simoni
“sun|“sũ
“sá|“sá
“sálọ|“sálɔ
“sì|“sì
“sí|“sí
“síbẹ̀|“síbɛ̀
“síbẹ̀síbẹ̀|“síbɛ̀síbɛ̀
“síwájú|“síwád͡ʒú
“sọ|“sɔ
“sọtẹ́lẹ̀|“sɔtɛ́lɛ̀
“sọ̀kalẹ̀|“sɔ̀kalɛ̀
“ta|“ta
“tabita|“tabita
“tamari|“tamari
“ti|“ti
“tinútinú|“tĩútĩú
“torí|“torí
“tàbí|“tàbí
“tèmi|“tèmi
“tètè|“tètè
“tìrẹ|“tìrɛ
“tí|“tí
“títí|“títí
“tú|“tú
“tújúká|“túd͡ʒúká
“tẹ|“tɛ
“tẹ̀lé|“tɛ̀lé
“tẹ́|“tɛ́
“tẹ́tí|“tɛ́tí
“tọ|“tɔ
“wà|“wà
“wá|“wá
“wádìí|“wádìí
“wákàtí|“wákàtí
“wí|“wí
“wò|“wò
“wòlíì|“wòlíì
“wó|“wó
“wúrà|“wúrà
“wúńdíá|“wúńdíá
“wọ|“wɔ
“wọlé|“wɔlé
“wọn|“wɔ̃
“wọ̀nyí|“wɔ̀njí
“wọ́n|“wɔ́n
“yin|“jĩ
“yé|“jé
“yíyẹ|“jíjɛ
“yóò|“jóò
“à|“à
“àbí|“àbí
“àbúrò|“àbúrò
“àdàbà|“àdàbà
“àdúrà|“àdúrà
“àfi|“àfi
“àgbáǹréré|“àɡ͡báǹréré
“àgbẹ̀|“àɡ͡bɛ̀
“àgùntàn|“àɡùntàn
“àgọ́|“àɡɔ́
“àkàrà|“àkàrà
“àkókò|“àkókò
“àlejò|“àled͡ʒò
“àlàáfíà|“àlàáfíà
“àlàáfíà”|“àlàáfíà”
“àmì|“àmì
“àmín|“àmín
“àmín”|“àmín”
“àní|“àní
“àrá|“àrá
“àti|“àti
“àwa|“àwa
“àwàdà|“àwàdà
“àwòrán|“àwòrán
“àwọn|“àwɔ̃
“àyàfi|“àjàfi
“àádọ́rin|“àádɔ́rĩ
“àánú|“àánú
“àìsàn|“àìsàn
“àṣẹ|“àʃɛ
“á|“á
“ábbà|“ábbà
“ègbé|“èɡ͡bé
“ègún|“èɡún
“èkejì|“èked͡ʒì
“èmi|“èmi
“èmí|“èmí
“èrè|“èrè
“èwo|“èwo
“èyí|“èjí
“èèkàn|“èèkàn
“èéha|“èéha
“èétirí|“èétirí
“èétiṣe|“èétiʃe
“èéṣe|“èéʃe
“ìbá|“ìbá
“ìbínú|“ìbínú
“ìbùkún|“ìbùkún
“ìbẹ̀rù|“ìbɛ̀rù
“ìfibú|“ìfibú
“ìfẹ́|“ìfɛ́
“ìfọ́nnu|“ìfɔ́nnu
“ìgbà|“ìɡ͡bà
“ìjọba|“ìd͡ʒɔba
“ìlàjì|“ìlàd͡ʒì
“ìlúkílùú|“ìlúkílùú
“ìran|“ìran
“ìránṣẹ́|“ìránʃɛ́
“ìránṣẹ́bìnrin|“ìránʃɛ́bìnrĩ
“ìríjú|“ìríd͡ʒú
“ìrònú|“ìrònú
“ìró|“ìró
“ìtara|“ìtara
“ìtumọ̀|“ìtumɔ̀
“ìtẹ́|“ìtɛ́
“ìwo|“ìwo
“ìwọ|“ìwɔ
“ìwọ̀nyí|“ìwɔ̀njí
“ìwọ́|“ìwɔ́
“ìyá|“ìjá
“ìyìn|“ìjìn
“ìyẹn|“ìjɛ̃
“ìṣubú|“ìʃubú
“ògo|“òɡo
“òkìtì|“òkìtì
“òkúta|“òkúta
“òní|“òní
“òrìṣà|“òrìʃà
“òtítọ́|“òtítɔ́
“òun|“òũ
“ó|“ó
“ǹjẹ́|“ǹd͡ʒɛ́
“ṣadraki|“ʃadraki
“ṣe|“ʃe
“ṣàánú|“ʃàánú
“ṣé|“ʃé
“ṣí|“ʃí
“ṣùgbọ́n|“ʃùɡ͡bɔ́n
“ṣọ́ra|“ʃɔ́ra
“ẹ|“ɛ
“ẹgbẹ́|“ɛɡ͡bɛ́
“ẹgbọrọ|“ɛɡ͡bɔrɔ
“ẹlẹ́jẹ̀|“ɛlɛ́d͡ʒɛ̀
“ẹni|“ɛ̃i
“ẹnikẹ́|“ɛ̃ikɛ́
“ẹnikẹ́ni|“ɛ̃ikɛ́ni
“ẹnu|“ɛ̃u
“ẹnìkan|“ɛ̃ìkan
“ẹrú|“ɛrú
“ẹsẹ̀|“ɛsɛ̀
“ẹwà|“ɛwà
“ẹyin|“ɛjĩ
“ẹ̀bẹ̀|“ɛ̀bɛ̀
“ẹ̀gbọ́n|“ɛ̀ɡ͡bɔ́n
“ẹ̀gàn|“ɛ̀ɡàn
“ẹ̀jẹ̀|“ɛ̀d͡ʒɛ̀
“ẹ̀mí|“ɛ̀mí
“ẹ̀rù|“ɛ̀rù
“ẹ̀yin|“ɛ̀jĩ
“ẹ̀ṣẹ̀|“ɛ̀ʃɛ̀
“ẹ̀ẹ́dẹ́gbẹ̀fà|“ɛ̀ɛ́dɛ́ɡ͡bɛ̀fà
“ọba|“ɔba
“ọfà|“ɔfà
“ọgọ́rùn|“ɔɡɔ́rùn
“ọjọ́|“ɔd͡ʒɔ́
“ọkàn|“ɔkàn
“ọkùnrin|“ɔkùnrĩ
“ọlọ́run|“ɔlɔ́rũ
“ọmọ|“ɔmɔ
“ọmọbìnrin|“ɔmɔbìnrĩ
“ọmọdé|“ɔmɔdé
“ọrùn|“ɔrùn
“ọwọ́|“ɔwɔ́
“ọ̀fọ̀|“ɔ̀fɔ̀
“ọ̀kan|“ɔ̀kan
“ọ̀lẹ|“ɔ̀lɛ
“ọ̀nà|“ɔ̀nà
“ọ̀pọ̀lọpọ̀|“ɔ̀k͡pɔ̀lɔk͡pɔ̀
“ọ̀rọ̀|“ɔ̀rɔ̀
“ọ̀tẹ̀|“ɔ̀tɛ̀
“ọ̀yà|“ɔ̀jà
”|”